,province,date,testing,cumulative_testing,testing_info
0,Alberta,15-03-2020,7108,7108,
1,Alberta,16-03-2020,3490,10598,
2,Alberta,17-03-2020,1757,12355,
3,Alberta,18-03-2020,2211,14566,
4,Alberta,19-03-2020,2447,17013,
5,Alberta,20-03-2020,3347,20360,
6,Alberta,21-03-2020,3382,23742,
7,Alberta,22-03-2020,3257,26999,
8,Alberta,23-03-2020,3059,30058,
9,Alberta,24-03-2020,2718,32776,
10,Alberta,25-03-2020,2732,35508,
11,Alberta,26-03-2020,1152,36660,
12,Alberta,27-03-2020,1555,38215,
13,Alberta,28-03-2020,4312,42527,
14,Alberta,29-03-2020,2472,44999,
15,Alberta,30-03-2020,1058,46057,
16,Alberta,31-03-2020,2635,48692,
17,Alberta,01-04-2020,4449,53141,
18,Alberta,02-04-2020,3955,57096,
19,Alberta,03-04-2020,4864,61960,
20,Alberta,04-04-2020,2148,64108,
21,Alberta,05-04-2020,985,65093,
22,Alberta,06-04-2020,821,65914,
23,Alberta,07-04-2020,1203,67117,
24,Alberta,08-04-2020,1645,68762,
25,Alberta,09-04-2020,1485,70247,
26,Alberta,10-04-2020,2123,72370,
27,Alberta,11-04-2020,2908,75278,
28,Alberta,12-04-2020,2038,77316,
29,Alberta,13-04-2020,2465,79781,
30,Alberta,14-04-2020,2868,82649,
31,Alberta,15-04-2020,2853,85502,
32,Alberta,16-04-2020,0,85502,
33,Alberta,17-04-2020,7303,92805,
34,Alberta,18-04-2020,4092,96897,
35,Alberta,19-04-2020,4426,101323,
36,Alberta,20-04-2020,3994,105317,
37,Alberta,21-04-2020,3698,109015,
38,Alberta,22-04-2020,4484,113499,
39,Alberta,23-04-2020,4336,117835,
40,Alberta,24-04-2020,4612,122447,
41,Alberta,25-04-2020,4718,127165,
42,Alberta,26-04-2020,4407,131572,
43,Alberta,27-04-2020,3870,135442,
44,Alberta,28-04-2020,3239,138681,
45,Alberta,29-04-2020,5205,143886,
46,Alberta,30-04-2020,5051,148937,
47,Alberta,01-05-2020,4829,153766,
48,Alberta,02-05-2020,3751,157517,
49,Alberta,03-05-2020,3728,161245,
50,Alberta,04-05-2020,3477,164722,
51,Alberta,05-05-2020,2293,167015,
52,Alberta,06-05-2020,3494,170509,
53,Alberta,07-05-2020,3818,174327,
54,Alberta,08-05-2020,3232,177559,
55,Alberta,09-05-2020,3548,181107,
56,Alberta,10-05-2020,4186,185293,
57,Alberta,11-05-2020,2864,188157,
58,Alberta,12-05-2020,3173,191330,
59,Alberta,13-05-2020,4072,195402,
60,Alberta,14-05-2020,4816,200218,
61,Alberta,15-05-2020,4505,204723,
62,Alberta,16-05-2020,4594,209317,
63,Alberta,17-05-2020,3761,213078,
64,Alberta,18-05-2020,3458,216536,
65,Alberta,19-05-2020,2428,218964,
66,Alberta,20-05-2020,2607,221571,
67,Alberta,21-05-2020,4017,225588,
68,Alberta,22-05-2020,3205,228793,
69,Alberta,23-05-2020,3981,232774,
70,Alberta,24-05-2020,4015,236789,
71,Alberta,25-05-2020,3010,239799,
72,Alberta,26-05-2020,2982,242781,
73,Alberta,27-05-2020,3168,245949,
74,Alberta,28-05-2020,3756,249705,
75,Alberta,29-05-2020,3754,253459,
76,Alberta,30-05-2020,2768,256227,
77,Alberta,31-05-2020,4138,260365,
78,Alberta,01-06-2020,2709,263074,
79,Alberta,02-06-2020,3227,266301,
80,Alberta,03-06-2020,4997,271298,
81,Alberta,04-06-2020,4226,275524,
82,Alberta,05-06-2020,6455,281979,
83,Alberta,06-06-2020,5692,287671,
84,Alberta,07-06-2020,0,287671,
85,Alberta,08-06-2020,11025,298696,
86,Alberta,09-06-2020,4993,303689,
87,Alberta,10-06-2020,6582,310271,
88,Alberta,11-06-2020,7131,317402,
89,Alberta,12-06-2020,7746,325148,
90,Alberta,13-06-2020,6790,331938,
91,Alberta,14-06-2020,7911,339849,
92,Alberta,15-06-2020,3462,343311,
93,Alberta,16-06-2020,6525,349836,
94,Alberta,17-06-2020,6982,356818,
95,Alberta,18-06-2020,7911,364729,
96,Alberta,19-06-2020,8995,373724,
97,Alberta,20-06-2020,7351,381075,
98,Alberta,21-06-2020,8330,389405,
99,Alberta,22-06-2020,6895,396300,
100,Alberta,23-06-2020,6537,402837,
101,Alberta,24-06-2020,6515,409352,
102,Alberta,25-06-2020,6364,415716,
103,Alberta,26-06-2020,6635,422351,
104,Alberta,27-06-2020,6392,428743,
105,Alberta,28-06-2020,6511,435254,
106,Alberta,29-06-2020,6999,442253,
107,Alberta,30-06-2020,7198,449451,
108,Alberta,01-07-2020,0,449451,
109,Alberta,02-07-2020,14619,464070,
110,Alberta,03-07-2020,6739,470809,
111,Alberta,04-07-2020,0,470809,
112,Alberta,05-07-2020,0,470809,
113,Alberta,06-07-2020,17106,487915,
114,Alberta,07-07-2020,6020,493935,
115,Alberta,08-07-2020,6268,500203,
116,Alberta,09-07-2020,6966,507169,
117,Alberta,10-07-2020,7801,514970,
118,Alberta,11-07-2020,0,514970,
119,Alberta,12-07-2020,0,514970,
120,Alberta,13-07-2020,25132,540102,
121,Alberta,14-07-2020,5800,545902,
122,Alberta,15-07-2020,6374,552276,
123,Alberta,16-07-2020,8217,560493,
124,Alberta,17-07-2020,6479,566972,
125,Alberta,18-07-2020,0,566972,
126,Alberta,19-07-2020,0,566972,
127,Alberta,20-07-2020,23530,590502,
128,Alberta,21-07-2020,7815,598317,
129,Alberta,22-07-2020,8148,606465,
130,Alberta,23-07-2020,8227,614692,
131,Alberta,24-07-2020,8730,623422,
132,Alberta,25-07-2020,7448,630870,
133,Alberta,26-07-2020,9848,640718,
134,Alberta,27-07-2020,10617,651335,
135,Alberta,28-07-2020,7907,659242,
136,Alberta,29-07-2020,8984,668226,
137,Alberta,30-07-2020,8687,676913,
138,Alberta,31-07-2020,8384,685297,
139,Alberta,01-08-2020,11501,696798,
140,Alberta,02-08-2020,9144,705942,
141,Alberta,03-08-2020,6933,712875,
142,Alberta,04-08-2020,7236,720111,
143,Alberta,05-08-2020,7224,727335,
144,Alberta,06-08-2020,7987,735322,
145,Alberta,07-08-2020,8563,743885,
146,Alberta,08-08-2020,7436,751321,
147,Alberta,09-08-2020,10166,761487,
148,Alberta,10-08-2020,8779,770266,
149,Alberta,11-08-2020,7059,777325,
150,Alberta,12-08-2020,8036,785361,
151,Alberta,13-08-2020,7753,793114,
152,Alberta,14-08-2020,8246,801360,
153,Alberta,15-08-2020,8713,810073,
154,Alberta,16-08-2020,8663,818736,
155,Alberta,17-08-2020,10886,829622,
156,Alberta,18-08-2020,8027,837649,
157,Alberta,19-08-2020,9032,846681,
158,Alberta,20-08-2020,9287,855968,
159,Alberta,21-08-2020,9867,865835,
160,Alberta,22-08-2020,8505,874340,
161,Alberta,23-08-2020,10096,884436,
162,Alberta,24-08-2020,10175,894611,
163,Alberta,25-08-2020,8441,903052,
164,Alberta,26-08-2020,9250,912302,
165,Alberta,27-08-2020,10095,922397,
166,Alberta,28-08-2020,10968,933365,
167,Alberta,29-08-2020,0,933365,
168,Alberta,30-08-2020,0,933365,
169,BC,15-03-2020,6326,6326,
170,BC,16-03-2020,0,6326,
171,BC,17-03-2020,0,6326,
172,BC,18-03-2020,0,6326,
173,BC,19-03-2020,0,6326,
174,BC,20-03-2020,11586,17912,
175,BC,21-03-2020,3384,21296,
176,BC,22-03-2020,5385,26681,
177,BC,23-03-2020,0,26681,
178,BC,24-03-2020,0,26681,
179,BC,25-03-2020,5058,31739,
180,BC,26-03-2020,2822,34561,
181,BC,27-03-2020,2082,36643,
182,BC,28-03-2020,2054,38697,
183,BC,29-03-2020,0,38697,
184,BC,30-03-2020,3331,42028,
185,BC,31-03-2020,1201,43229,
186,BC,01-04-2020,1410,44639,
187,BC,02-04-2020,1327,45966,
188,BC,03-04-2020,1386,47352,
189,BC,04-04-2020,1156,48508,
190,BC,05-04-2020,0,48508,
191,BC,06-04-2020,1842,50350,
192,BC,07-04-2020,1073,51423,
193,BC,08-04-2020,989,52412,
194,BC,09-04-2020,1093,53505,
195,BC,10-04-2020,0,53505,
196,BC,11-04-2020,0,53505,
197,BC,12-04-2020,0,53505,
198,BC,13-04-2020,2637,56142,
199,BC,14-04-2020,2484,58626,
200,BC,15-04-2020,-629,57997,Change in reported testing definition.
201,BC,16-04-2020,1132,59129,
202,BC,17-04-2020,1539,60668,
203,BC,18-04-2020,0,60668,
204,BC,19-04-2020,0,60668,
205,BC,20-04-2020,3707,64375,
206,BC,21-04-2020,1170,65545,
207,BC,22-04-2020,1432,66977,
208,BC,23-04-2020,1576,68553,
209,BC,24-04-2020,2862,71415,
210,BC,25-04-2020,0,71415,
211,BC,26-04-2020,0,71415,
212,BC,27-04-2020,7250,78665,
213,BC,28-04-2020,2223,80888,
214,BC,29-04-2020,2537,83425,
215,BC,30-04-2020,2605,86030,
216,BC,01-05-2020,2640,88670,
217,BC,02-05-2020,0,88670,
218,BC,03-05-2020,0,88670,
219,BC,04-05-2020,7847,96517,
220,BC,05-05-2020,1682,98199,
221,BC,06-05-2020,1894,100093,
222,BC,07-05-2020,2617,102710,
223,BC,08-05-2020,2284,104994,
224,BC,09-05-2020,0,104994,
225,BC,10-05-2020,0,104994,
226,BC,11-05-2020,6504,111498,
227,BC,12-05-2020,1496,112994,
228,BC,13-05-2020,1767,114761,
229,BC,14-05-2020,2003,116764,
230,BC,15-05-2020,1571,118335,
231,BC,16-05-2020,0,118335,
232,BC,17-05-2020,0,118335,
233,BC,18-05-2020,0,118335,
234,BC,19-05-2020,6709,125044,
235,BC,20-05-2020,1192,126236,
236,BC,21-05-2020,1550,127786,
237,BC,22-05-2020,2156,129942,
238,BC,23-05-2020,0,129942,
239,BC,24-05-2020,0,129942,
240,BC,25-05-2020,5248,135190,
241,BC,26-05-2020,1131,136321,
242,BC,27-05-2020,1722,138043,
243,BC,28-05-2020,2093,140136,
244,BC,29-05-2020,1256,141392,
245,BC,30-05-2020,0,141392,
246,BC,31-05-2020,3874,145266,
247,BC,01-06-2020,1166,146432,
248,BC,02-06-2020,1325,147757,
249,BC,03-06-2020,1720,149477,
250,BC,04-06-2020,1981,151458,
251,BC,05-06-2020,1901,153359,
252,BC,06-06-2020,0,153359,
253,BC,07-06-2020,0,153359,
254,BC,08-06-2020,4681,158040,
255,BC,09-06-2020,1955,159995,
256,BC,10-06-2020,1439,161434,
257,BC,11-06-2020,1922,163356,
258,BC,12-06-2020,1900,165256,
259,BC,13-06-2020,0,165256,
260,BC,14-06-2020,1677,166933,
261,BC,15-06-2020,1315,168248,
262,BC,16-06-2020,1469,169717,
263,BC,17-06-2020,1866,171583,
264,BC,18-06-2020,2024,173607,
265,BC,19-06-2020,1847,175454,
266,BC,20-06-2020,0,175454,
267,BC,21-06-2020,0,175454,
268,BC,22-06-2020,5019,180473,
269,BC,23-06-2020,1231,181704,
270,BC,24-06-2020,1664,183368,
271,BC,25-06-2020,2391,185759,
272,BC,26-06-2020,1989,187748,
273,BC,27-06-2020,0,187748,
274,BC,28-06-2020,0,187748,
275,BC,29-06-2020,4684,192432,
276,BC,30-06-2020,1320,193752,
277,BC,01-07-2020,0,193752,
278,BC,02-07-2020,3494,197246,
279,BC,03-07-2020,1519,198765,
280,BC,04-07-2020,0,198765,
281,BC,05-07-2020,0,198765,
282,BC,06-07-2020,5631,204396,
283,BC,07-07-2020,1241,205637,
284,BC,08-07-2020,2059,207696,
285,BC,09-07-2020,2139,209835,
286,BC,10-07-2020,2624,212459,
287,BC,11-07-2020,0,212459,
288,BC,12-07-2020,0,212459,
289,BC,13-07-2020,7142,219601,
290,BC,14-07-2020,1496,221097,
291,BC,15-07-2020,2396,223493,
292,BC,16-07-2020,2654,226147,
293,BC,17-07-2020,3146,229293,
294,BC,18-07-2020,0,229293,
295,BC,19-07-2020,0,229293,
296,BC,20-07-2020,7376,236669,
297,BC,21-07-2020,1677,238346,
298,BC,22-07-2020,2667,241013,
299,BC,23-07-2020,3136,244149,
300,BC,24-07-2020,2566,246715,
301,BC,25-07-2020,0,246715,
302,BC,26-07-2020,5289,252004,
303,BC,27-07-2020,1869,253873,
304,BC,28-07-2020,1855,255728,
305,BC,29-07-2020,2640,258368,
306,BC,30-07-2020,3370,261738,
307,BC,31-07-2020,3266,265004,
308,BC,01-08-2020,0,265004,
309,BC,02-08-2020,0,265004,
310,BC,03-08-2020,0,265004,
311,BC,04-08-2020,7449,272453,
312,BC,05-08-2020,1726,274179,
313,BC,06-08-2020,2560,276739,
314,BC,07-08-2020,2983,279722,
315,BC,08-08-2020,0,279722,
316,BC,09-08-2020,0,279722,
317,BC,10-08-2020,8356,288078,
318,BC,11-08-2020,2072,290150,
319,BC,12-08-2020,2977,293127,
320,BC,13-08-2020,3615,296742,
321,BC,14-08-2020,3488,300230,
322,BC,15-08-2020,0,300230,
323,BC,16-08-2020,0,300230,
324,BC,17-08-2020,10730,310960,
325,BC,18-08-2020,2325,313285,
326,BC,19-08-2020,3497,316782,
327,BC,20-08-2020,4207,320989,
328,BC,21-08-2020,4370,325359,
329,BC,22-08-2020,0,325359,
330,BC,23-08-2020,0,325359,
331,BC,24-08-2020,11367,336726,
332,BC,25-08-2020,2030,338756,
333,BC,26-08-2020,4409,343165,
334,BC,27-08-2020,4592,347757,
335,BC,28-08-2020,5417,353174,
336,BC,29-08-2020,0,353174,
337,BC,30-08-2020,0,353174,
338,Manitoba,15-03-2020,400,400,
339,Manitoba,16-03-2020,1880,2280,
340,Manitoba,17-03-2020,632,2912,
341,Manitoba,18-03-2020,358,3270,
342,Manitoba,19-03-2020,264,3534,
343,Manitoba,20-03-2020,0,3534,
344,Manitoba,21-03-2020,267,3801,
345,Manitoba,22-03-2020,444,4245,
346,Manitoba,23-03-2020,0,4245,
347,Manitoba,24-03-2020,275,4520,
348,Manitoba,25-03-2020,0,4520,
349,Manitoba,26-03-2020,1086,5606,
350,Manitoba,27-03-2020,597,6203,
351,Manitoba,28-03-2020,0,6203,
352,Manitoba,29-03-2020,944,7147,
353,Manitoba,30-03-2020,1403,8550,
354,Manitoba,31-03-2020,364,8914,
355,Manitoba,01-04-2020,1130,10044,
356,Manitoba,02-04-2020,1283,11327,
357,Manitoba,03-04-2020,625,11952,
358,Manitoba,04-04-2020,562,12514,
359,Manitoba,05-04-2020,484,12998,
360,Manitoba,06-04-2020,478,13476,
361,Manitoba,07-04-2020,804,14280,
362,Manitoba,08-04-2020,428,14708,
363,Manitoba,09-04-2020,551,15259,
364,Manitoba,10-04-2020,961,16220,
365,Manitoba,11-04-2020,163,16383,
366,Manitoba,12-04-2020,838,17221,
367,Manitoba,13-04-2020,24,17245,
368,Manitoba,14-04-2020,464,17709,
369,Manitoba,15-04-2020,193,17902,
370,Manitoba,16-04-2020,447,18349,
371,Manitoba,17-04-2020,507,18856,
372,Manitoba,18-04-2020,337,19193,
373,Manitoba,19-04-2020,551,19744,
374,Manitoba,20-04-2020,268,20012,
375,Manitoba,21-04-2020,307,20319,
376,Manitoba,22-04-2020,742,21061,
377,Manitoba,23-04-2020,326,21387,
378,Manitoba,24-04-2020,785,22172,
379,Manitoba,25-04-2020,426,22598,
380,Manitoba,26-04-2020,569,23167,
381,Manitoba,27-04-2020,376,23543,
382,Manitoba,28-04-2020,314,23857,
383,Manitoba,29-04-2020,447,24304,
384,Manitoba,30-04-2020,419,24723,
385,Manitoba,01-05-2020,679,25402,
386,Manitoba,02-05-2020,767,26169,
387,Manitoba,03-05-2020,637,26806,
388,Manitoba,04-05-2020,640,27446,
389,Manitoba,05-05-2020,329,27775,
390,Manitoba,06-05-2020,519,28294,
391,Manitoba,07-05-2020,516,28810,
392,Manitoba,08-05-2020,533,29343,
393,Manitoba,09-05-2020,671,30014,
394,Manitoba,10-05-2020,633,30647,
395,Manitoba,11-05-2020,382,31029,
396,Manitoba,12-05-2020,411,31440,
397,Manitoba,13-05-2020,506,31946,
398,Manitoba,14-05-2020,298,32244,
399,Manitoba,15-05-2020,801,33045,
400,Manitoba,16-05-2020,908,33953,
401,Manitoba,17-05-2020,762,34715,
402,Manitoba,18-05-2020,485,35200,
403,Manitoba,19-05-2020,378,35578,
404,Manitoba,20-05-2020,242,35820,
405,Manitoba,21-05-2020,582,36402,
406,Manitoba,22-05-2020,870,37272,
407,Manitoba,23-05-2020,598,37870,
408,Manitoba,24-05-2020,729,38599,
409,Manitoba,25-05-2020,363,38962,
410,Manitoba,26-05-2020,359,39321,
411,Manitoba,27-05-2020,1145,40466,
412,Manitoba,28-05-2020,725,41191,
413,Manitoba,29-05-2020,1115,42306,
414,Manitoba,30-05-2020,702,43008,
415,Manitoba,31-05-2020,878,43886,
416,Manitoba,01-06-2020,806,44692,
417,Manitoba,02-06-2020,407,45099,
418,Manitoba,03-06-2020,703,45802,
419,Manitoba,04-06-2020,899,46701,
420,Manitoba,05-06-2020,671,47372,
421,Manitoba,06-06-2020,0,47372,
422,Manitoba,07-06-2020,0,47372,
423,Manitoba,08-06-2020,2219,49591,
424,Manitoba,09-06-2020,497,50088,
425,Manitoba,10-06-2020,638,50726,
426,Manitoba,11-06-2020,734,51460,
427,Manitoba,12-06-2020,795,52255,
428,Manitoba,13-06-2020,0,52255,
429,Manitoba,14-06-2020,0,52255,
430,Manitoba,15-06-2020,2126,54381,
431,Manitoba,16-06-2020,233,54614,
432,Manitoba,17-06-2020,483,55097,
433,Manitoba,18-06-2020,646,55743,
434,Manitoba,19-06-2020,574,56317,
435,Manitoba,20-06-2020,0,56317,
436,Manitoba,21-06-2020,0,56317,
437,Manitoba,22-06-2020,1904,58221,
438,Manitoba,23-06-2020,580,58801,
439,Manitoba,24-06-2020,556,59357,
440,Manitoba,25-06-2020,0,59357,
441,Manitoba,26-06-2020,1418,60775,
442,Manitoba,27-06-2020,0,60775,
443,Manitoba,28-06-2020,0,60775,
444,Manitoba,29-06-2020,2281,63056,
445,Manitoba,30-06-2020,253,63309,
446,Manitoba,01-07-2020,0,63309,
447,Manitoba,02-07-2020,1020,64329,
448,Manitoba,03-07-2020,639,64968,
449,Manitoba,04-07-2020,0,64968,
450,Manitoba,05-07-2020,0,64968,
451,Manitoba,06-07-2020,1749,66717,
452,Manitoba,07-07-2020,289,67006,
453,Manitoba,08-07-2020,612,67618,
454,Manitoba,09-07-2020,397,68015,
455,Manitoba,10-07-2020,1021,69036,
456,Manitoba,11-07-2020,0,69036,
457,Manitoba,12-07-2020,0,69036,
458,Manitoba,13-07-2020,2523,71559,
459,Manitoba,14-07-2020,244,71803,
460,Manitoba,15-07-2020,505,72308,
461,Manitoba,16-07-2020,734,73042,
462,Manitoba,17-07-2020,843,73885,
463,Manitoba,18-07-2020,0,73885,
464,Manitoba,19-07-2020,0,73885,
465,Manitoba,20-07-2020,2469,76354,
466,Manitoba,21-07-2020,1197,77551,
467,Manitoba,22-07-2020,732,78283,
468,Manitoba,23-07-2020,1263,79546,
469,Manitoba,24-07-2020,1640,81186,
470,Manitoba,25-07-2020,0,81186,
471,Manitoba,26-07-2020,0,81186,
472,Manitoba,27-07-2020,3781,84967,
473,Manitoba,28-07-2020,735,85702,
474,Manitoba,29-07-2020,665,86367,
475,Manitoba,30-07-2020,1181,87548,
476,Manitoba,31-07-2020,1073,88621,
477,Manitoba,01-08-2020,0,88621,
478,Manitoba,02-08-2020,0,88621,
479,Manitoba,03-08-2020,0,88621,
480,Manitoba,04-08-2020,5374,93995,
481,Manitoba,05-08-2020,989,94984,
482,Manitoba,06-08-2020,563,95547,
483,Manitoba,07-08-2020,1452,96999,
484,Manitoba,08-08-2020,3075,100074,
485,Manitoba,09-08-2020,756,100830,
486,Manitoba,10-08-2020,2952,103782,
487,Manitoba,11-08-2020,1059,104841,
488,Manitoba,12-08-2020,820,105661,
489,Manitoba,13-08-2020,2550,108211,
490,Manitoba,14-08-2020,2281,110492,
491,Manitoba,15-08-2020,1791,112283,
492,Manitoba,16-08-2020,1669,113952,
493,Manitoba,17-08-2020,2011,115963,
494,Manitoba,18-08-2020,1027,116990,
495,Manitoba,19-08-2020,1374,118364,
496,Manitoba,20-08-2020,846,119210,
497,Manitoba,21-08-2020,3081,122291,
498,Manitoba,22-08-2020,1849,124140,
499,Manitoba,23-08-2020,1160,125300,
500,Manitoba,24-08-2020,1849,127149,
501,Manitoba,25-08-2020,1427,128576,
502,Manitoba,26-08-2020,833,129409,
503,Manitoba,27-08-2020,1426,130835,
504,Manitoba,28-08-2020,1250,132085,
505,Manitoba,29-08-2020,1293,133378,
506,Manitoba,30-08-2020,1542,134920,
507,New Brunswick,15-03-2020,0,0,
508,New Brunswick,16-03-2020,203,203,
509,New Brunswick,17-03-2020,1,204,
510,New Brunswick,18-03-2020,177,381,
511,New Brunswick,19-03-2020,40,421,
512,New Brunswick,20-03-2020,99,520,
513,New Brunswick,21-03-2020,268,788,
514,New Brunswick,22-03-2020,70,858,
515,New Brunswick,23-03-2020,238,1096,
516,New Brunswick,24-03-2020,159,1255,
517,New Brunswick,25-03-2020,295,1550,
518,New Brunswick,26-03-2020,278,1828,
519,New Brunswick,27-03-2020,191,2019,
520,New Brunswick,28-03-2020,586,2605,
521,New Brunswick,29-03-2020,326,2931,
522,New Brunswick,30-03-2020,303,3234,
523,New Brunswick,31-03-2020,302,3536,
524,New Brunswick,01-04-2020,494,4030,
525,New Brunswick,02-04-2020,490,4520,
526,New Brunswick,03-04-2020,386,4906,
527,New Brunswick,04-04-2020,442,5348,
528,New Brunswick,05-04-2020,195,5543,
529,New Brunswick,06-04-2020,265,5808,
530,New Brunswick,07-04-2020,304,6112,
531,New Brunswick,08-04-2020,437,6549,
532,New Brunswick,09-04-2020,381,6930,
533,New Brunswick,10-04-2020,423,7353,
534,New Brunswick,11-04-2020,330,7683,
535,New Brunswick,12-04-2020,280,7963,
536,New Brunswick,13-04-2020,236,8199,
537,New Brunswick,14-04-2020,250,8449,
538,New Brunswick,15-04-2020,375,8824,
539,New Brunswick,16-04-2020,490,9314,
540,New Brunswick,17-04-2020,586,9900,
541,New Brunswick,18-04-2020,447,10347,
542,New Brunswick,19-04-2020,395,10742,
543,New Brunswick,20-04-2020,228,10970,
544,New Brunswick,21-04-2020,311,11281,
545,New Brunswick,22-04-2020,260,11541,
546,New Brunswick,23-04-2020,473,12014,
547,New Brunswick,24-04-2020,404,12418,
548,New Brunswick,25-04-2020,368,12786,
549,New Brunswick,26-04-2020,240,13026,
550,New Brunswick,27-04-2020,170,13196,
551,New Brunswick,28-04-2020,234,13430,
552,New Brunswick,29-04-2020,269,13699,
553,New Brunswick,30-04-2020,418,14117,
554,New Brunswick,01-05-2020,525,14642,
555,New Brunswick,02-05-2020,416,15058,
556,New Brunswick,03-05-2020,308,15366,
557,New Brunswick,04-05-2020,219,15585,
558,New Brunswick,05-05-2020,171,15756,
559,New Brunswick,06-05-2020,490,16246,
560,New Brunswick,07-05-2020,379,16625,
561,New Brunswick,08-05-2020,404,17029,
562,New Brunswick,09-05-2020,397,17426,
563,New Brunswick,10-05-2020,346,17772,
564,New Brunswick,11-05-2020,290,18062,
565,New Brunswick,12-05-2020,317,18379,
566,New Brunswick,13-05-2020,479,18858,
567,New Brunswick,14-05-2020,449,19307,
568,New Brunswick,15-05-2020,406,19713,
569,New Brunswick,16-05-2020,319,20032,
570,New Brunswick,17-05-2020,285,20317,
571,New Brunswick,18-05-2020,246,20563,
572,New Brunswick,19-05-2020,228,20791,
573,New Brunswick,20-05-2020,353,21144,
574,New Brunswick,21-05-2020,330,21474,
575,New Brunswick,22-05-2020,278,21752,
576,New Brunswick,23-05-2020,237,21989,
577,New Brunswick,24-05-2020,312,22301,
578,New Brunswick,25-05-2020,271,22572,
579,New Brunswick,26-05-2020,348,22920,
580,New Brunswick,27-05-2020,376,23296,
581,New Brunswick,28-05-2020,397,23693,
582,New Brunswick,29-05-2020,476,24169,
583,New Brunswick,30-05-2020,698,24867,
584,New Brunswick,31-05-2020,1305,26172,
585,New Brunswick,01-06-2020,2290,28462,
586,New Brunswick,02-06-2020,2204,30666,
587,New Brunswick,03-06-2020,1125,31791,
588,New Brunswick,04-06-2020,508,32299,
589,New Brunswick,05-06-2020,655,32954,
590,New Brunswick,06-06-2020,381,33335,
591,New Brunswick,07-06-2020,381,33716,
592,New Brunswick,08-06-2020,684,34400,
593,New Brunswick,09-06-2020,414,34814,
594,New Brunswick,10-06-2020,449,35263,
595,New Brunswick,11-06-2020,490,35753,
596,New Brunswick,12-06-2020,372,36125,
597,New Brunswick,13-06-2020,480,36605,
598,New Brunswick,14-06-2020,467,37072,
599,New Brunswick,15-06-2020,437,37509,
600,New Brunswick,16-06-2020,334,37843,
601,New Brunswick,17-06-2020,871,38714,
602,New Brunswick,18-06-2020,586,39300,
603,New Brunswick,19-06-2020,506,39806,
604,New Brunswick,20-06-2020,449,40255,
605,New Brunswick,21-06-2020,235,40490,
606,New Brunswick,22-06-2020,173,40663,
607,New Brunswick,23-06-2020,169,40832,
608,New Brunswick,24-06-2020,524,41356,
609,New Brunswick,25-06-2020,334,41690,
610,New Brunswick,26-06-2020,460,42150,
611,New Brunswick,27-06-2020,343,42493,
612,New Brunswick,28-06-2020,261,42754,
613,New Brunswick,29-06-2020,171,42925,
614,New Brunswick,30-06-2020,237,43162,
615,New Brunswick,01-07-2020,272,43434,
616,New Brunswick,02-07-2020,180,43614,
617,New Brunswick,03-07-2020,237,43851,
618,New Brunswick,04-07-2020,292,44143,
619,New Brunswick,05-07-2020,204,44347,
620,New Brunswick,06-07-2020,215,44562,
621,New Brunswick,07-07-2020,256,44818,
622,New Brunswick,08-07-2020,362,45180,
623,New Brunswick,09-07-2020,342,45522,
624,New Brunswick,10-07-2020,344,45866,
625,New Brunswick,11-07-2020,348,46214,
626,New Brunswick,12-07-2020,288,46502,
627,New Brunswick,13-07-2020,-13,46489,Change in reported testing definition.
628,New Brunswick,14-07-2020,438,46927,
629,New Brunswick,15-07-2020,344,47271,
630,New Brunswick,16-07-2020,471,47742,
631,New Brunswick,17-07-2020,354,48096,
632,New Brunswick,18-07-2020,400,48496,
633,New Brunswick,19-07-2020,312,48808,
634,New Brunswick,20-07-2020,275,49083,
635,New Brunswick,21-07-2020,286,49369,
636,New Brunswick,22-07-2020,349,49718,
637,New Brunswick,23-07-2020,394,50112,
638,New Brunswick,24-07-2020,368,50480,
639,New Brunswick,25-07-2020,341,50821,
640,New Brunswick,26-07-2020,211,51032,
641,New Brunswick,27-07-2020,212,51244,
642,New Brunswick,28-07-2020,278,51522,
643,New Brunswick,29-07-2020,270,51792,
644,New Brunswick,30-07-2020,361,52153,
645,New Brunswick,31-07-2020,316,52469,
646,New Brunswick,01-08-2020,297,52766,
647,New Brunswick,02-08-2020,280,53046,
648,New Brunswick,03-08-2020,197,53243,
649,New Brunswick,04-08-2020,158,53401,
650,New Brunswick,05-08-2020,298,53699,
651,New Brunswick,06-08-2020,300,53999,
652,New Brunswick,07-08-2020,282,54281,
653,New Brunswick,08-08-2020,350,54631,
654,New Brunswick,09-08-2020,223,54854,
655,New Brunswick,10-08-2020,218,55072,
656,New Brunswick,11-08-2020,307,55379,
657,New Brunswick,12-08-2020,234,55613,
658,New Brunswick,13-08-2020,332,55945,
659,New Brunswick,14-08-2020,278,56223,
660,New Brunswick,15-08-2020,307,56530,
661,New Brunswick,16-08-2020,236,56766,
662,New Brunswick,17-08-2020,194,56960,
663,New Brunswick,18-08-2020,286,57246,
664,New Brunswick,19-08-2020,265,57511,
665,New Brunswick,20-08-2020,367,57878,
666,New Brunswick,21-08-2020,349,58227,
667,New Brunswick,22-08-2020,343,58570,
668,New Brunswick,23-08-2020,287,58857,
669,New Brunswick,24-08-2020,255,59112,
670,New Brunswick,25-08-2020,256,59368,
671,New Brunswick,26-08-2020,497,59865,
672,New Brunswick,27-08-2020,440,60305,
673,New Brunswick,28-08-2020,293,60598,
674,New Brunswick,29-08-2020,388,60986,
675,New Brunswick,30-08-2020,286,61272,
676,NL,15-03-2020,161,161,
677,NL,16-03-2020,0,161,
678,NL,17-03-2020,333,494,
679,NL,18-03-2020,0,494,
680,NL,19-03-2020,0,494,
681,NL,20-03-2020,297,791,
682,NL,21-03-2020,110,901,
683,NL,22-03-2020,69,970,
684,NL,23-03-2020,-32,938,Change in reported testing definition.
685,NL,24-03-2020,193,1131,
686,NL,25-03-2020,205,1336,
687,NL,26-03-2020,155,1491,
688,NL,27-03-2020,193,1684,
689,NL,28-03-2020,243,1927,
690,NL,29-03-2020,180,2107,
691,NL,30-03-2020,225,2332,
692,NL,31-03-2020,243,2575,
693,NL,01-04-2020,241,2816,
694,NL,02-04-2020,113,2929,
695,NL,03-04-2020,272,3201,
696,NL,04-04-2020,185,3386,
697,NL,05-04-2020,179,3565,
698,NL,06-04-2020,211,3776,
699,NL,07-04-2020,182,3958,
700,NL,08-04-2020,191,4149,
701,NL,09-04-2020,241,4390,
702,NL,10-04-2020,130,4520,
703,NL,11-04-2020,206,4726,
704,NL,12-04-2020,86,4812,
705,NL,13-04-2020,95,4907,
706,NL,14-04-2020,114,5021,
707,NL,15-04-2020,145,5166,
708,NL,16-04-2020,204,5370,
709,NL,17-04-2020,215,5585,
710,NL,18-04-2020,286,5871,
711,NL,19-04-2020,273,6144,
712,NL,20-04-2020,105,6249,
713,NL,21-04-2020,182,6431,
714,NL,22-04-2020,231,6662,
715,NL,23-04-2020,240,6902,
716,NL,24-04-2020,232,7134,
717,NL,25-04-2020,198,7332,
718,NL,26-04-2020,145,7477,
719,NL,27-04-2020,145,7622,
720,NL,28-04-2020,333,7955,
721,NL,29-04-2020,265,8220,
722,NL,30-04-2020,156,8376,
723,NL,01-05-2020,176,8552,
724,NL,02-05-2020,164,8716,
725,NL,03-05-2020,117,8833,
726,NL,04-05-2020,128,8961,
727,NL,05-05-2020,178,9139,
728,NL,06-05-2020,157,9296,
729,NL,07-05-2020,162,9458,
730,NL,08-05-2020,134,9592,
731,NL,09-05-2020,108,9700,
732,NL,10-05-2020,121,9821,
733,NL,11-05-2020,79,9900,
734,NL,12-05-2020,152,10052,
735,NL,13-05-2020,100,10152,
736,NL,14-05-2020,123,10275,
737,NL,15-05-2020,71,10346,
738,NL,16-05-2020,179,10525,
739,NL,17-05-2020,98,10623,
740,NL,18-05-2020,53,10676,
741,NL,19-05-2020,71,10747,
742,NL,20-05-2020,94,10841,
743,NL,21-05-2020,142,10983,
744,NL,22-05-2020,122,11105,
745,NL,23-05-2020,103,11208,
746,NL,24-05-2020,79,11287,
747,NL,25-05-2020,60,11347,
748,NL,26-05-2020,148,11495,
749,NL,27-05-2020,122,11617,
750,NL,28-05-2020,158,11775,
751,NL,29-05-2020,132,11907,
752,NL,30-05-2020,188,12095,
753,NL,31-05-2020,101,12196,
754,NL,01-06-2020,57,12253,
755,NL,02-06-2020,180,12433,
756,NL,03-06-2020,186,12619,
757,NL,04-06-2020,200,12819,
758,NL,05-06-2020,133,12952,
759,NL,06-06-2020,270,13222,
760,NL,07-06-2020,113,13335,
761,NL,08-06-2020,114,13449,
762,NL,09-06-2020,306,13755,
763,NL,10-06-2020,137,13892,
764,NL,11-06-2020,225,14117,
765,NL,12-06-2020,139,14256,
766,NL,13-06-2020,243,14499,
767,NL,14-06-2020,93,14592,
768,NL,15-06-2020,125,14717,
769,NL,16-06-2020,204,14921,
770,NL,17-06-2020,222,15143,
771,NL,18-06-2020,179,15322,
772,NL,19-06-2020,251,15573,
773,NL,20-06-2020,227,15800,
774,NL,21-06-2020,182,15982,
775,NL,22-06-2020,169,16151,
776,NL,23-06-2020,279,16430,
777,NL,24-06-2020,190,16620,
778,NL,25-06-2020,281,16901,
779,NL,26-06-2020,157,17058,
780,NL,27-06-2020,212,17270,
781,NL,28-06-2020,170,17440,
782,NL,29-06-2020,109,17549,
783,NL,30-06-2020,231,17780,
784,NL,01-07-2020,204,17984,
785,NL,02-07-2020,234,18218,
786,NL,03-07-2020,138,18356,
787,NL,04-07-2020,230,18586,
788,NL,05-07-2020,196,18782,
789,NL,06-07-2020,138,18920,
790,NL,07-07-2020,264,19184,
791,NL,08-07-2020,291,19475,
792,NL,09-07-2020,311,19786,
793,NL,10-07-2020,184,19970,
794,NL,11-07-2020,205,20175,
795,NL,12-07-2020,262,20437,
796,NL,13-07-2020,146,20583,
797,NL,14-07-2020,244,20827,
798,NL,15-07-2020,307,21134,
799,NL,16-07-2020,285,21419,
800,NL,17-07-2020,170,21589,
801,NL,18-07-2020,235,21824,
802,NL,19-07-2020,152,21976,
803,NL,20-07-2020,155,22131,
804,NL,21-07-2020,330,22461,
805,NL,22-07-2020,249,22710,
806,NL,23-07-2020,274,22984,
807,NL,24-07-2020,270,23254,
808,NL,25-07-2020,107,23361,
809,NL,26-07-2020,296,23657,
810,NL,27-07-2020,182,23839,
811,NL,28-07-2020,346,24185,
812,NL,29-07-2020,260,24445,
813,NL,30-07-2020,227,24672,
814,NL,31-07-2020,254,24926,
815,NL,01-08-2020,200,25126,
816,NL,02-08-2020,203,25329,
817,NL,03-08-2020,123,25452,
818,NL,04-08-2020,322,25774,
819,NL,05-08-2020,236,26010,
820,NL,06-08-2020,270,26280,
821,NL,07-08-2020,199,26479,
822,NL,08-08-2020,217,26696,
823,NL,09-08-2020,210,26906,
824,NL,10-08-2020,144,27050,
825,NL,11-08-2020,329,27379,
826,NL,12-08-2020,289,27668,
827,NL,13-08-2020,243,27911,
828,NL,14-08-2020,235,28146,
829,NL,15-08-2020,138,28284,
830,NL,16-08-2020,195,28479,
831,NL,17-08-2020,189,28668,
832,NL,18-08-2020,216,28884,
833,NL,19-08-2020,292,29176,
834,NL,20-08-2020,310,29486,
835,NL,21-08-2020,296,29782,
836,NL,22-08-2020,117,29899,
837,NL,23-08-2020,241,30140,
838,NL,24-08-2020,173,30313,
839,NL,25-08-2020,261,30574,
840,NL,26-08-2020,233,30807,
841,NL,27-08-2020,281,31088,
842,NL,28-08-2020,283,31371,
843,NL,29-08-2020,196,31567,
844,NL,30-08-2020,225,31792,
845,Nova Scotia,15-03-2020,418,418,
846,Nova Scotia,16-03-2020,258,676,
847,Nova Scotia,17-03-2020,265,941,
848,Nova Scotia,18-03-2020,212,1153,
849,Nova Scotia,19-03-2020,234,1387,
850,Nova Scotia,20-03-2020,174,1561,
851,Nova Scotia,21-03-2020,286,1847,
852,Nova Scotia,22-03-2020,269,2116,
853,Nova Scotia,23-03-2020,233,2349,
854,Nova Scotia,24-03-2020,176,2525,
855,Nova Scotia,25-03-2020,315,2840,
856,Nova Scotia,26-03-2020,434,3274,
857,Nova Scotia,27-03-2020,465,3739,
858,Nova Scotia,28-03-2020,402,4141,
859,Nova Scotia,29-03-2020,712,4853,
860,Nova Scotia,30-03-2020,319,5172,
861,Nova Scotia,31-03-2020,738,5910,
862,Nova Scotia,01-04-2020,854,6764,
863,Nova Scotia,02-04-2020,875,7639,
864,Nova Scotia,03-04-2020,802,8441,
865,Nova Scotia,04-04-2020,759,9200,
866,Nova Scotia,05-04-2020,572,9772,
867,Nova Scotia,06-04-2020,739,10511,
868,Nova Scotia,07-04-2020,420,10931,
869,Nova Scotia,08-04-2020,757,11688,
870,Nova Scotia,09-04-2020,862,12550,
871,Nova Scotia,10-04-2020,871,13421,
872,Nova Scotia,11-04-2020,639,14060,
873,Nova Scotia,12-04-2020,680,14740,
874,Nova Scotia,13-04-2020,1314,16054,
875,Nova Scotia,14-04-2020,1218,17272,
876,Nova Scotia,15-04-2020,696,17968,
877,Nova Scotia,16-04-2020,1064,19032,
878,Nova Scotia,17-04-2020,1080,20112,
879,Nova Scotia,18-04-2020,849,20961,
880,Nova Scotia,19-04-2020,834,21795,
881,Nova Scotia,20-04-2020,695,22490,
882,Nova Scotia,21-04-2020,437,22927,
883,Nova Scotia,22-04-2020,838,23765,
884,Nova Scotia,23-04-2020,793,24558,
885,Nova Scotia,24-04-2020,813,25371,
886,Nova Scotia,25-04-2020,613,25984,
887,Nova Scotia,26-04-2020,504,26488,
888,Nova Scotia,27-04-2020,643,27131,
889,Nova Scotia,28-04-2020,686,27817,
890,Nova Scotia,29-04-2020,604,28421,
891,Nova Scotia,30-04-2020,735,29156,
892,Nova Scotia,01-05-2020,686,29842,
893,Nova Scotia,02-05-2020,527,30369,
894,Nova Scotia,03-05-2020,547,30916,
895,Nova Scotia,04-05-2020,510,31426,
896,Nova Scotia,05-05-2020,549,31975,
897,Nova Scotia,06-05-2020,564,32539,
898,Nova Scotia,07-05-2020,757,33296,
899,Nova Scotia,08-05-2020,547,33843,
900,Nova Scotia,09-05-2020,358,34201,
901,Nova Scotia,10-05-2020,396,34597,
902,Nova Scotia,11-05-2020,291,34888,
903,Nova Scotia,12-05-2020,336,35224,
904,Nova Scotia,13-05-2020,404,35628,
905,Nova Scotia,14-05-2020,402,36030,
906,Nova Scotia,15-05-2020,379,36409,
907,Nova Scotia,16-05-2020,331,36740,
908,Nova Scotia,17-05-2020,270,37010,
909,Nova Scotia,18-05-2020,296,37306,
910,Nova Scotia,19-05-2020,176,37482,
911,Nova Scotia,20-05-2020,219,37701,
912,Nova Scotia,21-05-2020,423,38124,
913,Nova Scotia,22-05-2020,329,38453,
914,Nova Scotia,23-05-2020,267,38720,
915,Nova Scotia,24-05-2020,385,39105,
916,Nova Scotia,25-05-2020,404,39509,
917,Nova Scotia,26-05-2020,542,40051,
918,Nova Scotia,27-05-2020,443,40494,
919,Nova Scotia,28-05-2020,801,41295,
920,Nova Scotia,29-05-2020,674,41969,
921,Nova Scotia,30-05-2020,478,42447,
922,Nova Scotia,31-05-2020,553,43000,
923,Nova Scotia,01-06-2020,483,43483,
924,Nova Scotia,02-06-2020,435,43918,
925,Nova Scotia,03-06-2020,480,44398,
926,Nova Scotia,04-06-2020,571,44969,
927,Nova Scotia,05-06-2020,566,45535,
928,Nova Scotia,06-06-2020,617,46152,
929,Nova Scotia,07-06-2020,373,46525,
930,Nova Scotia,08-06-2020,0,46525,
931,Nova Scotia,09-06-2020,0,46525,
932,Nova Scotia,10-06-2020,1204,47729,
933,Nova Scotia,11-06-2020,477,48206,
934,Nova Scotia,12-06-2020,581,48787,
935,Nova Scotia,13-06-2020,658,49445,
936,Nova Scotia,14-06-2020,402,49847,
937,Nova Scotia,15-06-2020,314,50161,
938,Nova Scotia,16-06-2020,298,50459,
939,Nova Scotia,17-06-2020,377,50836,
940,Nova Scotia,18-06-2020,465,51301,
941,Nova Scotia,19-06-2020,300,51601,
942,Nova Scotia,20-06-2020,285,51886,
943,Nova Scotia,21-06-2020,286,52172,
944,Nova Scotia,22-06-2020,131,52303,
945,Nova Scotia,23-06-2020,288,52591,
946,Nova Scotia,24-06-2020,287,52878,
947,Nova Scotia,25-06-2020,449,53327,
948,Nova Scotia,26-06-2020,287,53614,
949,Nova Scotia,27-06-2020,258,53872,
950,Nova Scotia,28-06-2020,245,54117,
951,Nova Scotia,29-06-2020,207,54324,
952,Nova Scotia,30-06-2020,282,54606,
953,Nova Scotia,01-07-2020,304,54910,
954,Nova Scotia,02-07-2020,148,55058,
955,Nova Scotia,03-07-2020,323,55381,
956,Nova Scotia,04-07-2020,362,55743,
957,Nova Scotia,05-07-2020,231,55974,
958,Nova Scotia,06-07-2020,204,56178,
959,Nova Scotia,07-07-2020,315,56493,
960,Nova Scotia,08-07-2020,391,56884,
961,Nova Scotia,09-07-2020,409,57293,
962,Nova Scotia,10-07-2020,387,57680,
963,Nova Scotia,11-07-2020,362,58042,
964,Nova Scotia,12-07-2020,319,58361,
965,Nova Scotia,13-07-2020,380,58741,
966,Nova Scotia,14-07-2020,274,59015,
967,Nova Scotia,15-07-2020,367,59382,
968,Nova Scotia,16-07-2020,413,59795,
969,Nova Scotia,17-07-2020,396,60191,
970,Nova Scotia,18-07-2020,296,60487,
971,Nova Scotia,19-07-2020,369,60856,
972,Nova Scotia,20-07-2020,283,61139,
973,Nova Scotia,21-07-2020,279,61418,
974,Nova Scotia,22-07-2020,351,61769,
975,Nova Scotia,23-07-2020,537,62306,
976,Nova Scotia,24-07-2020,387,62693,
977,Nova Scotia,25-07-2020,288,62981,
978,Nova Scotia,26-07-2020,273,63254,
979,Nova Scotia,27-07-2020,145,63399,
980,Nova Scotia,28-07-2020,244,63643,
981,Nova Scotia,29-07-2020,285,63928,
982,Nova Scotia,30-07-2020,351,64279,
983,Nova Scotia,31-07-2020,437,64716,
984,Nova Scotia,01-08-2020,265,64981,
985,Nova Scotia,02-08-2020,274,65255,
986,Nova Scotia,03-08-2020,228,65483,
987,Nova Scotia,04-08-2020,85,65568,
988,Nova Scotia,05-08-2020,281,65849,
989,Nova Scotia,06-08-2020,381,66230,
990,Nova Scotia,07-08-2020,449,66679,
991,Nova Scotia,08-08-2020,341,67020,
992,Nova Scotia,09-08-2020,165,67185,
993,Nova Scotia,10-08-2020,201,67386,
994,Nova Scotia,11-08-2020,274,67660,
995,Nova Scotia,12-08-2020,254,67914,
996,Nova Scotia,13-08-2020,467,68381,
997,Nova Scotia,14-08-2020,403,68784,
998,Nova Scotia,15-08-2020,410,69194,
999,Nova Scotia,16-08-2020,343,69537,
1000,Nova Scotia,17-08-2020,176,69713,
1001,Nova Scotia,18-08-2020,263,69976,
1002,Nova Scotia,19-08-2020,412,70388,
1003,Nova Scotia,20-08-2020,451,70839,
1004,Nova Scotia,21-08-2020,553,71392,
1005,Nova Scotia,22-08-2020,308,71700,
1006,Nova Scotia,23-08-2020,398,72098,
1007,Nova Scotia,24-08-2020,461,72559,
1008,Nova Scotia,25-08-2020,479,73038,
1009,Nova Scotia,26-08-2020,575,73613,
1010,Nova Scotia,27-08-2020,613,74226,
1011,Nova Scotia,28-08-2020,694,74920,
1012,Nova Scotia,29-08-2020,661,75581,
1013,Nova Scotia,30-08-2020,646,76227,
1014,Nunavut,15-03-2020,0,0,
1015,Nunavut,16-03-2020,0,0,
1016,Nunavut,17-03-2020,0,0,
1017,Nunavut,18-03-2020,0,0,
1018,Nunavut,19-03-2020,0,0,
1019,Nunavut,20-03-2020,108,108,
1020,Nunavut,21-03-2020,0,108,
1021,Nunavut,22-03-2020,0,108,
1022,Nunavut,23-03-2020,0,108,
1023,Nunavut,24-03-2020,46,154,
1024,Nunavut,25-03-2020,12,166,
1025,Nunavut,26-03-2020,0,166,
1026,Nunavut,27-03-2020,41,207,
1027,Nunavut,28-03-2020,0,207,
1028,Nunavut,29-03-2020,0,207,
1029,Nunavut,30-03-2020,52,259,
1030,Nunavut,31-03-2020,0,259,
1031,Nunavut,01-04-2020,31,290,
1032,Nunavut,02-04-2020,0,290,
1033,Nunavut,03-04-2020,24,314,
1034,Nunavut,04-04-2020,0,314,
1035,Nunavut,05-04-2020,0,314,
1036,Nunavut,06-04-2020,42,356,
1037,Nunavut,07-04-2020,0,356,
1038,Nunavut,08-04-2020,13,369,
1039,Nunavut,09-04-2020,7,376,
1040,Nunavut,10-04-2020,0,376,
1041,Nunavut,11-04-2020,0,376,
1042,Nunavut,12-04-2020,0,376,
1043,Nunavut,13-04-2020,23,399,
1044,Nunavut,14-04-2020,0,399,
1045,Nunavut,15-04-2020,5,404,
1046,Nunavut,16-04-2020,0,404,
1047,Nunavut,17-04-2020,26,430,
1048,Nunavut,18-04-2020,0,430,
1049,Nunavut,19-04-2020,0,430,
1050,Nunavut,20-04-2020,23,453,
1051,Nunavut,21-04-2020,0,453,
1052,Nunavut,22-04-2020,32,485,
1053,Nunavut,23-04-2020,0,485,
1054,Nunavut,24-04-2020,45,530,
1055,Nunavut,25-04-2020,0,530,
1056,Nunavut,26-04-2020,0,530,
1057,Nunavut,27-04-2020,20,550,
1058,Nunavut,28-04-2020,0,550,
1059,Nunavut,29-04-2020,30,580,
1060,Nunavut,30-04-2020,22,602,
1061,Nunavut,01-05-2020,0,602,
1062,Nunavut,02-05-2020,0,602,
1063,Nunavut,03-05-2020,0,602,
1064,Nunavut,04-05-2020,101,703,
1065,Nunavut,05-05-2020,0,703,
1066,Nunavut,06-05-2020,75,778,
1067,Nunavut,07-05-2020,0,778,
1068,Nunavut,08-05-2020,27,805,
1069,Nunavut,09-05-2020,0,805,
1070,Nunavut,10-05-2020,0,805,
1071,Nunavut,11-05-2020,33,838,
1072,Nunavut,12-05-2020,0,838,
1073,Nunavut,13-05-2020,43,881,
1074,Nunavut,14-05-2020,0,881,
1075,Nunavut,15-05-2020,26,907,
1076,Nunavut,16-05-2020,0,907,
1077,Nunavut,17-05-2020,0,907,
1078,Nunavut,18-05-2020,41,948,
1079,Nunavut,19-05-2020,0,948,
1080,Nunavut,20-05-2020,0,948,
1081,Nunavut,21-05-2020,24,972,
1082,Nunavut,22-05-2020,0,972,
1083,Nunavut,23-05-2020,0,972,
1084,Nunavut,24-05-2020,0,972,
1085,Nunavut,25-05-2020,38,1010,
1086,Nunavut,26-05-2020,0,1010,
1087,Nunavut,27-05-2020,34,1044,
1088,Nunavut,28-05-2020,0,1044,
1089,Nunavut,29-05-2020,26,1070,
1090,Nunavut,30-05-2020,0,1070,
1091,Nunavut,31-05-2020,0,1070,
1092,Nunavut,01-06-2020,33,1103,
1093,Nunavut,02-06-2020,0,1103,
1094,Nunavut,03-06-2020,9,1112,
1095,Nunavut,04-06-2020,0,1112,
1096,Nunavut,05-06-2020,33,1145,
1097,Nunavut,06-06-2020,0,1145,
1098,Nunavut,07-06-2020,0,1145,
1099,Nunavut,08-06-2020,21,1166,
1100,Nunavut,09-06-2020,0,1166,
1101,Nunavut,10-06-2020,0,1166,
1102,Nunavut,11-06-2020,31,1197,
1103,Nunavut,12-06-2020,0,1197,
1104,Nunavut,13-06-2020,0,1197,
1105,Nunavut,14-06-2020,0,1197,
1106,Nunavut,15-06-2020,42,1239,
1107,Nunavut,16-06-2020,0,1239,
1108,Nunavut,17-06-2020,0,1239,
1109,Nunavut,18-06-2020,49,1288,
1110,Nunavut,19-06-2020,0,1288,
1111,Nunavut,20-06-2020,0,1288,
1112,Nunavut,21-06-2020,0,1288,
1113,Nunavut,22-06-2020,57,1345,
1114,Nunavut,23-06-2020,0,1345,
1115,Nunavut,24-06-2020,0,1345,
1116,Nunavut,25-06-2020,13,1358,
1117,Nunavut,26-06-2020,0,1358,
1118,Nunavut,27-06-2020,0,1358,
1119,Nunavut,28-06-2020,0,1358,
1120,Nunavut,29-06-2020,60,1418,
1121,Nunavut,30-06-2020,0,1418,
1122,Nunavut,01-07-2020,0,1418,
1123,Nunavut,02-07-2020,0,1418,
1124,Nunavut,03-07-2020,49,1467,
1125,Nunavut,04-07-2020,0,1467,
1126,Nunavut,05-07-2020,0,1467,
1127,Nunavut,06-07-2020,0,1467,
1128,Nunavut,07-07-2020,0,1467,
1129,Nunavut,08-07-2020,0,1467,
1130,Nunavut,09-07-2020,0,1467,
1131,Nunavut,10-07-2020,0,1467,
1132,Nunavut,11-07-2020,0,1467,
1133,Nunavut,12-07-2020,0,1467,
1134,Nunavut,13-07-2020,86,1553,
1135,Nunavut,14-07-2020,0,1553,
1136,Nunavut,15-07-2020,0,1553,
1137,Nunavut,16-07-2020,28,1581,
1138,Nunavut,17-07-2020,101,1682,
1139,Nunavut,18-07-2020,0,1682,
1140,Nunavut,19-07-2020,0,1682,
1141,Nunavut,20-07-2020,0,1682,
1142,Nunavut,21-07-2020,0,1682,
1143,Nunavut,22-07-2020,-6,1676,Change in reported testing definition.
1144,Nunavut,23-07-2020,0,1676,
1145,Nunavut,24-07-2020,0,1676,
1146,Nunavut,25-07-2020,0,1676,
1147,Nunavut,26-07-2020,0,1676,
1148,Nunavut,27-07-2020,43,1719,
1149,Nunavut,28-07-2020,0,1719,
1150,Nunavut,29-07-2020,32,1751,
1151,Nunavut,30-07-2020,0,1751,
1152,Nunavut,31-07-2020,0,1751,
1153,Nunavut,01-08-2020,0,1751,
1154,Nunavut,02-08-2020,0,1751,
1155,Nunavut,03-08-2020,0,1751,
1156,Nunavut,04-08-2020,74,1825,
1157,Nunavut,05-08-2020,0,1825,
1158,Nunavut,06-08-2020,0,1825,
1159,Nunavut,07-08-2020,0,1825,
1160,Nunavut,08-08-2020,0,1825,
1161,Nunavut,09-08-2020,0,1825,
1162,Nunavut,10-08-2020,81,1906,
1163,Nunavut,11-08-2020,0,1906,
1164,Nunavut,12-08-2020,49,1955,
1165,Nunavut,13-08-2020,0,1955,
1166,Nunavut,14-08-2020,43,1998,
1167,Nunavut,15-08-2020,0,1998,
1168,Nunavut,16-08-2020,0,1998,
1169,Nunavut,17-08-2020,25,2023,
1170,Nunavut,18-08-2020,0,2023,
1171,Nunavut,19-08-2020,0,2023,
1172,Nunavut,20-08-2020,0,2023,
1173,Nunavut,21-08-2020,87,2110,
1174,Nunavut,22-08-2020,0,2110,
1175,Nunavut,23-08-2020,0,2110,
1176,Nunavut,24-08-2020,42,2152,
1177,Nunavut,25-08-2020,0,2152,
1178,Nunavut,26-08-2020,0,2152,
1179,Nunavut,27-08-2020,0,2152,
1180,Nunavut,28-08-2020,129,2281,
1181,Nunavut,29-08-2020,0,2281,
1182,Nunavut,30-08-2020,0,2281,
1183,NWT,15-03-2020,0,0,
1184,NWT,16-03-2020,143,143,
1185,NWT,17-03-2020,10,153,
1186,NWT,18-03-2020,0,153,
1187,NWT,19-03-2020,69,222,
1188,NWT,20-03-2020,53,275,
1189,NWT,21-03-2020,24,299,
1190,NWT,22-03-2020,71,370,
1191,NWT,23-03-2020,40,410,
1192,NWT,24-03-2020,82,492,
1193,NWT,25-03-2020,41,533,
1194,NWT,26-03-2020,26,559,
1195,NWT,27-03-2020,48,607,
1196,NWT,28-03-2020,155,762,
1197,NWT,29-03-2020,55,817,
1198,NWT,30-03-2020,16,833,
1199,NWT,31-03-2020,77,910,
1200,NWT,01-04-2020,69,979,
1201,NWT,02-04-2020,17,996,
1202,NWT,03-04-2020,145,1141,
1203,NWT,04-04-2020,63,1204,
1204,NWT,05-04-2020,51,1255,
1205,NWT,06-04-2020,7,1262,
1206,NWT,07-04-2020,13,1275,
1207,NWT,08-04-2020,24,1299,
1208,NWT,09-04-2020,15,1314,
1209,NWT,10-04-2020,83,1397,
1210,NWT,11-04-2020,32,1429,
1211,NWT,12-04-2020,19,1448,
1212,NWT,13-04-2020,0,1448,
1213,NWT,14-04-2020,8,1456,
1214,NWT,15-04-2020,8,1464,
1215,NWT,16-04-2020,41,1505,
1216,NWT,17-04-2020,9,1514,
1217,NWT,18-04-2020,16,1530,
1218,NWT,19-04-2020,21,1551,
1219,NWT,20-04-2020,23,1574,
1220,NWT,21-04-2020,19,1593,
1221,NWT,22-04-2020,4,1597,
1222,NWT,23-04-2020,8,1605,
1223,NWT,24-04-2020,23,1628,
1224,NWT,25-04-2020,19,1647,
1225,NWT,26-04-2020,23,1670,
1226,NWT,27-04-2020,13,1683,
1227,NWT,28-04-2020,1,1684,
1228,NWT,29-04-2020,26,1710,
1229,NWT,30-04-2020,26,1736,
1230,NWT,01-05-2020,22,1758,
1231,NWT,02-05-2020,36,1794,
1232,NWT,03-05-2020,16,1810,
1233,NWT,04-05-2020,2,1812,
1234,NWT,05-05-2020,25,1837,
1235,NWT,06-05-2020,18,1855,
1236,NWT,07-05-2020,23,1878,
1237,NWT,08-05-2020,0,1878,
1238,NWT,09-05-2020,33,1911,
1239,NWT,10-05-2020,19,1930,
1240,NWT,11-05-2020,14,1944,
1241,NWT,12-05-2020,1,1945,
1242,NWT,13-05-2020,15,1960,
1243,NWT,14-05-2020,17,1977,
1244,NWT,15-05-2020,12,1989,
1245,NWT,16-05-2020,17,2006,
1246,NWT,17-05-2020,16,2022,
1247,NWT,18-05-2020,12,2034,
1248,NWT,19-05-2020,0,2034,
1249,NWT,20-05-2020,0,2034,
1250,NWT,21-05-2020,14,2048,
1251,NWT,22-05-2020,8,2056,
1252,NWT,23-05-2020,0,2056,
1253,NWT,24-05-2020,0,2056,
1254,NWT,25-05-2020,57,2113,
1255,NWT,26-05-2020,3,2116,
1256,NWT,27-05-2020,19,2135,
1257,NWT,28-05-2020,26,2161,
1258,NWT,29-05-2020,10,2171,
1259,NWT,30-05-2020,0,2171,
1260,NWT,31-05-2020,0,2171,
1261,NWT,01-06-2020,59,2230,
1262,NWT,02-06-2020,3,2233,
1263,NWT,03-06-2020,23,2256,
1264,NWT,04-06-2020,13,2269,
1265,NWT,05-06-2020,14,2283,
1266,NWT,06-06-2020,0,2283,
1267,NWT,07-06-2020,0,2283,
1268,NWT,08-06-2020,39,2322,
1269,NWT,09-06-2020,12,2334,
1270,NWT,10-06-2020,10,2344,
1271,NWT,11-06-2020,20,2364,
1272,NWT,12-06-2020,13,2377,
1273,NWT,13-06-2020,0,2377,
1274,NWT,14-06-2020,0,2377,
1275,NWT,15-06-2020,0,2377,
1276,NWT,16-06-2020,58,2435,
1277,NWT,17-06-2020,2,2437,
1278,NWT,18-06-2020,7,2444,
1279,NWT,19-06-2020,8,2452,
1280,NWT,20-06-2020,0,2452,
1281,NWT,21-06-2020,0,2452,
1282,NWT,22-06-2020,0,2452,
1283,NWT,23-06-2020,95,2547,
1284,NWT,24-06-2020,1,2548,
1285,NWT,25-06-2020,14,2562,
1286,NWT,26-06-2020,17,2579,
1287,NWT,27-06-2020,0,2579,
1288,NWT,28-06-2020,0,2579,
1289,NWT,29-06-2020,26,2605,
1290,NWT,30-06-2020,8,2613,
1291,NWT,01-07-2020,0,2613,
1292,NWT,02-07-2020,31,2644,
1293,NWT,03-07-2020,17,2661,
1294,NWT,04-07-2020,0,2661,
1295,NWT,05-07-2020,0,2661,
1296,NWT,06-07-2020,38,2699,
1297,NWT,07-07-2020,20,2719,
1298,NWT,08-07-2020,29,2748,
1299,NWT,09-07-2020,27,2775,
1300,NWT,10-07-2020,15,2790,
1301,NWT,11-07-2020,0,2790,
1302,NWT,12-07-2020,0,2790,
1303,NWT,13-07-2020,69,2859,
1304,NWT,14-07-2020,15,2874,
1305,NWT,15-07-2020,40,2914,
1306,NWT,16-07-2020,10,2924,
1307,NWT,17-07-2020,10,2934,
1308,NWT,18-07-2020,0,2934,
1309,NWT,19-07-2020,0,2934,
1310,NWT,20-07-2020,61,2995,
1311,NWT,21-07-2020,13,3008,
1312,NWT,22-07-2020,25,3033,
1313,NWT,23-07-2020,18,3051,
1314,NWT,24-07-2020,0,3051,
1315,NWT,25-07-2020,9,3060,
1316,NWT,26-07-2020,0,3060,
1317,NWT,27-07-2020,70,3130,
1318,NWT,28-07-2020,14,3144,
1319,NWT,29-07-2020,19,3163,
1320,NWT,30-07-2020,52,3215,
1321,NWT,31-07-2020,12,3227,
1322,NWT,01-08-2020,0,3227,
1323,NWT,02-08-2020,0,3227,
1324,NWT,03-08-2020,0,3227,
1325,NWT,04-08-2020,112,3339,
1326,NWT,05-08-2020,25,3364,
1327,NWT,06-08-2020,22,3386,
1328,NWT,07-08-2020,7,3393,
1329,NWT,08-08-2020,0,3393,
1330,NWT,09-08-2020,0,3393,
1331,NWT,10-08-2020,76,3469,
1332,NWT,11-08-2020,32,3501,
1333,NWT,12-08-2020,24,3525,
1334,NWT,13-08-2020,12,3537,
1335,NWT,14-08-2020,24,3561,
1336,NWT,15-08-2020,0,3561,
1337,NWT,16-08-2020,0,3561,
1338,NWT,17-08-2020,88,3649,
1339,NWT,18-08-2020,18,3667,
1340,NWT,19-08-2020,16,3683,
1341,NWT,20-08-2020,16,3699,
1342,NWT,21-08-2020,4,3703,
1343,NWT,22-08-2020,0,3703,
1344,NWT,23-08-2020,0,3703,
1345,NWT,24-08-2020,95,3798,
1346,NWT,25-08-2020,5,3803,
1347,NWT,26-08-2020,4,3807,
1348,NWT,27-08-2020,34,3841,
1349,NWT,28-08-2020,15,3856,
1350,NWT,29-08-2020,0,3856,
1351,NWT,30-08-2020,0,3856,
1352,Ontario,15-03-2020,8465,8465,
1353,Ontario,16-03-2020,1713,10178,
1354,Ontario,17-03-2020,993,11171,
1355,Ontario,18-03-2020,2726,13897,
1356,Ontario,19-03-2020,2753,16650,
1357,Ontario,20-03-2020,2861,19511,
1358,Ontario,21-03-2020,3873,23384,
1359,Ontario,22-03-2020,3036,26420,
1360,Ontario,23-03-2020,2086,28506,
1361,Ontario,24-03-2020,3951,32457,
1362,Ontario,25-03-2020,3178,35635,
1363,Ontario,26-03-2020,2915,38550,
1364,Ontario,27-03-2020,2482,41032,
1365,Ontario,28-03-2020,2040,43072,
1366,Ontario,29-03-2020,6114,49186,
1367,Ontario,30-03-2020,-725,48461,Change in reported testing definition.
1368,Ontario,31-03-2020,3168,51629,
1369,Ontario,01-04-2020,6245,57874,
1370,Ontario,02-04-2020,4859,62733,
1371,Ontario,03-04-2020,4020,66753,
1372,Ontario,04-04-2020,4585,71338,
1373,Ontario,05-04-2020,3708,75046,
1374,Ontario,06-04-2020,3750,78796,
1375,Ontario,07-04-2020,2568,81364,
1376,Ontario,08-04-2020,3237,84601,
1377,Ontario,09-04-2020,4097,88698,
1378,Ontario,10-04-2020,3975,92673,
1379,Ontario,11-04-2020,3648,96321,
1380,Ontario,12-04-2020,6844,103165,
1381,Ontario,13-04-2020,5065,108230,
1382,Ontario,14-04-2020,4852,113082,
1383,Ontario,15-04-2020,6010,119092,Change in reported testing definition.
1384,Ontario,16-04-2020,9001,128093,
1385,Ontario,17-04-2020,8899,136992,
1386,Ontario,18-04-2020,9462,146454,
1387,Ontario,19-04-2020,9643,156097,
1388,Ontario,20-04-2020,8743,164840,
1389,Ontario,21-04-2020,9330,174170,
1390,Ontario,22-04-2020,10361,184531,
1391,Ontario,23-04-2020,10214,194745,
1392,Ontario,24-04-2020,12295,207040,
1393,Ontario,25-04-2020,10578,217618,
1394,Ontario,26-04-2020,12020,229638,
1395,Ontario,27-04-2020,12550,242188,
1396,Ontario,28-04-2020,10852,253040,
1397,Ontario,29-04-2020,11554,264594,
1398,Ontario,30-04-2020,12928,277522,
1399,Ontario,01-05-2020,16532,294054,
1400,Ontario,02-05-2020,16305,310359,
1401,Ontario,03-05-2020,17146,327505,
1402,Ontario,04-05-2020,14555,342060,
1403,Ontario,05-05-2020,10654,352714,
1404,Ontario,06-05-2020,12961,365675,
1405,Ontario,07-05-2020,15179,380854,
1406,Ontario,08-05-2020,16295,397149,
1407,Ontario,09-05-2020,19227,416376,
1408,Ontario,10-05-2020,17618,433994,
1409,Ontario,11-05-2020,13970,447964,
1410,Ontario,12-05-2020,11957,459921,
1411,Ontario,13-05-2020,15137,475058,
1412,Ontario,14-05-2020,17429,492487,
1413,Ontario,15-05-2020,18354,510841,
1414,Ontario,16-05-2020,17768,528609,
1415,Ontario,17-05-2020,16217,544826,
1416,Ontario,18-05-2020,9155,553981,
1417,Ontario,19-05-2020,5813,559794,
1418,Ontario,20-05-2020,7382,567176,
1419,Ontario,21-05-2020,10506,577682,
1420,Ontario,22-05-2020,11276,588958,
1421,Ontario,23-05-2020,11028,599986,
1422,Ontario,24-05-2020,11383,611369,
1423,Ontario,25-05-2020,8170,619539,
1424,Ontario,26-05-2020,9875,629414,
1425,Ontario,27-05-2020,15133,644547,
1426,Ontario,28-05-2020,17615,662162,
1427,Ontario,29-05-2020,18525,680687,
1428,Ontario,30-05-2020,20640,701327,
1429,Ontario,31-05-2020,17014,718341,
1430,Ontario,01-06-2020,14379,732720,
1431,Ontario,02-06-2020,15244,747964,
1432,Ontario,03-06-2020,17537,765501,
1433,Ontario,04-06-2020,20822,786323,
1434,Ontario,05-06-2020,22730,809053,
1435,Ontario,06-06-2020,23105,832158,
1436,Ontario,07-06-2020,19374,851532,
1437,Ontario,08-06-2020,15357,866889,
1438,Ontario,09-06-2020,13509,880398,
1439,Ontario,10-06-2020,19941,900339,
1440,Ontario,11-06-2020,24341,924680,
1441,Ontario,12-06-2020,28335,953015,
1442,Ontario,13-06-2020,27456,980471,
1443,Ontario,14-06-2020,23278,1003749,
1444,Ontario,15-06-2020,21751,1025500,
1445,Ontario,16-06-2020,21724,1047224,
1446,Ontario,17-06-2020,24205,1071429,
1447,Ontario,18-06-2020,25278,1096707,
1448,Ontario,19-06-2020,27225,1123932,
1449,Ontario,20-06-2020,27387,1151319,
1450,Ontario,21-06-2020,23408,1174727,
1451,Ontario,22-06-2020,21900,1196627,
1452,Ontario,23-06-2020,16189,1212816,
1453,Ontario,24-06-2020,23207,1236023,
1454,Ontario,25-06-2020,27511,1263534,
1455,Ontario,26-06-2020,30780,1294314,
1456,Ontario,27-06-2020,33492,1327806,
1457,Ontario,28-06-2020,28633,1356439,
1458,Ontario,29-06-2020,27127,1383566,
1459,Ontario,30-06-2020,23759,1407325,
1460,Ontario,01-07-2020,0,1407325,
1461,Ontario,02-07-2020,50378,1457703,
1462,Ontario,03-07-2020,24194,1481897,
1463,Ontario,04-07-2020,21425,1503322,
1464,Ontario,05-07-2020,23792,1527114,
1465,Ontario,06-07-2020,17303,1544417,
1466,Ontario,07-07-2020,15112,1559529,
1467,Ontario,08-07-2020,22832,1582361,
1468,Ontario,09-07-2020,26326,1608687,
1469,Ontario,10-07-2020,27484,1636171,
1470,Ontario,11-07-2020,29522,1665693,
1471,Ontario,12-07-2020,25726,1691419,
1472,Ontario,13-07-2020,20896,1712315,
1473,Ontario,14-07-2020,16744,1729059,
1474,Ontario,15-07-2020,23769,1752828,
1475,Ontario,16-07-2020,26492,1779320,
1476,Ontario,17-07-2020,31163,1810483,
1477,Ontario,18-07-2020,28849,1839332,
1478,Ontario,19-07-2020,26890,1866222,
1479,Ontario,20-07-2020,20913,1887135,
1480,Ontario,21-07-2020,22974,1910109,
1481,Ontario,22-07-2020,23990,1934099,
1482,Ontario,23-07-2020,26001,1960100,
1483,Ontario,24-07-2020,28809,1988909,
1484,Ontario,25-07-2020,29904,2018813,
1485,Ontario,26-07-2020,26144,2044957,
1486,Ontario,27-07-2020,24664,2069621,
1487,Ontario,28-07-2020,17334,2086955,
1488,Ontario,29-07-2020,27308,2114263,
1489,Ontario,30-07-2020,27676,2141939,
1490,Ontario,31-07-2020,30033,2171972,
1491,Ontario,01-08-2020,33282,2205254,
1492,Ontario,02-08-2020,30443,2235697,
1493,Ontario,03-08-2020,0,2235697,
1494,Ontario,04-08-2020,42190,2277887,
1495,Ontario,05-08-2020,17229,2295116,
1496,Ontario,06-08-2020,26181,2321297,
1497,Ontario,07-08-2020,25136,2346433,
1498,Ontario,08-08-2020,26008,2372441,
1499,Ontario,09-08-2020,27771,2400212,
1500,Ontario,10-08-2020,22275,2422487,
1501,Ontario,11-08-2020,21581,2444068,
1502,Ontario,12-08-2020,24572,2468640,
1503,Ontario,13-08-2020,29626,2498266,
1504,Ontario,14-08-2020,30137,2528403,
1505,Ontario,15-08-2020,30436,2558839,
1506,Ontario,16-08-2020,23813,2582652,
1507,Ontario,17-08-2020,25567,2608219,
1508,Ontario,18-08-2020,23067,2631286,
1509,Ontario,19-08-2020,25642,2656928,
1510,Ontario,20-08-2020,25917,2682845,
1511,Ontario,21-08-2020,28073,2710918,
1512,Ontario,22-08-2020,28656,2739574,
1513,Ontario,23-08-2020,23384,2762958,
1514,Ontario,24-08-2020,18790,2781748,
1515,Ontario,25-08-2020,20013,2801761,
1516,Ontario,26-08-2020,21960,2823721,
1517,Ontario,27-08-2020,28625,2852346,
1518,Ontario,28-08-2020,31823,2884169,
1519,Ontario,29-08-2020,32106,2916275,
1520,Ontario,30-08-2020,24970,2941245,
1521,PEI,15-03-2020,0,0,
1522,PEI,16-03-2020,0,0,
1523,PEI,17-03-2020,41,41,
1524,PEI,18-03-2020,0,41,
1525,PEI,19-03-2020,83,124,
1526,PEI,20-03-2020,45,169,
1527,PEI,21-03-2020,0,169,
1528,PEI,22-03-2020,65,234,
1529,PEI,23-03-2020,0,234,
1530,PEI,24-03-2020,0,234,
1531,PEI,25-03-2020,0,234,
1532,PEI,26-03-2020,110,344,
1533,PEI,27-03-2020,111,455,
1534,PEI,28-03-2020,0,455,
1535,PEI,29-03-2020,0,455,
1536,PEI,30-03-2020,153,608,
1537,PEI,31-03-2020,75,683,
1538,PEI,01-04-2020,3,686,
1539,PEI,02-04-2020,145,831,
1540,PEI,03-04-2020,4,835,
1541,PEI,04-04-2020,169,1004,
1542,PEI,05-04-2020,0,1004,
1543,PEI,06-04-2020,2,1006,
1544,PEI,07-04-2020,12,1018,
1545,PEI,08-04-2020,452,1470,
1546,PEI,09-04-2020,61,1531,
1547,PEI,10-04-2020,0,1531,
1548,PEI,11-04-2020,135,1666,
1549,PEI,12-04-2020,0,1666,
1550,PEI,13-04-2020,175,1841,
1551,PEI,14-04-2020,11,1852,
1552,PEI,15-04-2020,93,1945,
1553,PEI,16-04-2020,92,2037,
1554,PEI,17-04-2020,118,2155,
1555,PEI,18-04-2020,43,2198,
1556,PEI,19-04-2020,0,2198,
1557,PEI,20-04-2020,153,2351,
1558,PEI,21-04-2020,28,2379,
1559,PEI,22-04-2020,18,2397,
1560,PEI,23-04-2020,119,2516,
1561,PEI,24-04-2020,98,2614,
1562,PEI,25-04-2020,0,2614,
1563,PEI,26-04-2020,0,2614,
1564,PEI,27-04-2020,159,2773,
1565,PEI,28-04-2020,32,2805,
1566,PEI,29-04-2020,120,2925,
1567,PEI,30-04-2020,111,3036,
1568,PEI,01-05-2020,75,3111,
1569,PEI,02-05-2020,0,3111,
1570,PEI,03-05-2020,0,3111,
1571,PEI,04-05-2020,245,3356,
1572,PEI,05-05-2020,0,3356,
1573,PEI,06-05-2020,227,3583,
1574,PEI,07-05-2020,0,3583,
1575,PEI,08-05-2020,199,3782,
1576,PEI,09-05-2020,0,3782,
1577,PEI,10-05-2020,0,3782,
1578,PEI,11-05-2020,255,4037,
1579,PEI,12-05-2020,0,4037,
1580,PEI,13-05-2020,264,4301,
1581,PEI,14-05-2020,0,4301,
1582,PEI,15-05-2020,255,4556,
1583,PEI,16-05-2020,0,4556,
1584,PEI,17-05-2020,0,4556,
1585,PEI,18-05-2020,0,4556,
1586,PEI,19-05-2020,0,4556,
1587,PEI,20-05-2020,0,4556,
1588,PEI,21-05-2020,0,4556,
1589,PEI,22-05-2020,810,5366,
1590,PEI,23-05-2020,0,5366,
1591,PEI,24-05-2020,0,5366,
1592,PEI,25-05-2020,0,5366,
1593,PEI,26-05-2020,366,5732,
1594,PEI,27-05-2020,0,5732,
1595,PEI,28-05-2020,418,6150,
1596,PEI,29-05-2020,114,6264,
1597,PEI,30-05-2020,0,6264,
1598,PEI,31-05-2020,0,6264,
1599,PEI,01-06-2020,363,6627,
1600,PEI,02-06-2020,113,6740,
1601,PEI,03-06-2020,130,6870,
1602,PEI,04-06-2020,148,7018,
1603,PEI,05-06-2020,221,7239,
1604,PEI,06-06-2020,0,7239,
1605,PEI,07-06-2020,0,7239,
1606,PEI,08-06-2020,345,7584,
1607,PEI,09-06-2020,316,7900,
1608,PEI,10-06-2020,0,7900,
1609,PEI,11-06-2020,330,8230,
1610,PEI,12-06-2020,123,8353,
1611,PEI,13-06-2020,0,8353,
1612,PEI,14-06-2020,0,8353,
1613,PEI,15-06-2020,649,9002,
1614,PEI,16-06-2020,0,9002,
1615,PEI,17-06-2020,236,9238,
1616,PEI,18-06-2020,122,9360,
1617,PEI,19-06-2020,206,9566,
1618,PEI,20-06-2020,0,9566,
1619,PEI,21-06-2020,0,9566,
1620,PEI,22-06-2020,408,9974,
1621,PEI,23-06-2020,187,10161,
1622,PEI,24-06-2020,167,10328,
1623,PEI,25-06-2020,144,10472,
1624,PEI,26-06-2020,203,10675,
1625,PEI,27-06-2020,0,10675,
1626,PEI,28-06-2020,0,10675,
1627,PEI,29-06-2020,698,11373,
1628,PEI,30-06-2020,187,11560,
1629,PEI,01-07-2020,0,11560,
1630,PEI,02-07-2020,360,11920,
1631,PEI,03-07-2020,187,12107,
1632,PEI,04-07-2020,0,12107,
1633,PEI,05-07-2020,716,12823,
1634,PEI,06-07-2020,152,12975,
1635,PEI,07-07-2020,255,13230,
1636,PEI,08-07-2020,292,13522,
1637,PEI,09-07-2020,0,13522,
1638,PEI,10-07-2020,241,13763,
1639,PEI,11-07-2020,0,13763,
1640,PEI,12-07-2020,0,13763,
1641,PEI,13-07-2020,921,14684,
1642,PEI,14-07-2020,568,15252,
1643,PEI,15-07-2020,689,15941,
1644,PEI,16-07-2020,358,16299,
1645,PEI,17-07-2020,335,16634,
1646,PEI,18-07-2020,0,16634,
1647,PEI,19-07-2020,0,16634,
1648,PEI,20-07-2020,637,17271,
1649,PEI,21-07-2020,331,17602,
1650,PEI,22-07-2020,56,17658,
1651,PEI,23-07-2020,412,18070,
1652,PEI,24-07-2020,239,18309,
1653,PEI,25-07-2020,0,18309,
1654,PEI,26-07-2020,0,18309,
1655,PEI,27-07-2020,0,18309,
1656,PEI,28-07-2020,613,18922,
1657,PEI,29-07-2020,0,18922,
1658,PEI,30-07-2020,0,18922,
1659,PEI,31-07-2020,0,18922,
1660,PEI,01-08-2020,0,18922,
1661,PEI,02-08-2020,0,18922,
1662,PEI,03-08-2020,0,18922,
1663,PEI,04-08-2020,1477,20399,
1664,PEI,05-08-2020,0,20399,
1665,PEI,06-08-2020,0,20399,
1666,PEI,07-08-2020,0,20399,
1667,PEI,08-08-2020,-60,20339,
1668,PEI,09-08-2020,0,20339,
1669,PEI,10-08-2020,0,20339,
1670,PEI,11-08-2020,1478,21817,
1671,PEI,12-08-2020,0,21817,
1672,PEI,13-08-2020,512,22329,
1673,PEI,14-08-2020,0,22329,
1674,PEI,15-08-2020,0,22329,
1675,PEI,16-08-2020,0,22329,
1676,PEI,17-08-2020,0,22329,
1677,PEI,18-08-2020,0,22329,
1678,PEI,19-08-2020,0,22329,
1679,PEI,20-08-2020,0,22329,
1680,PEI,21-08-2020,0,22329,
1681,PEI,22-08-2020,0,22329,
1682,PEI,23-08-2020,0,22329,
1683,PEI,24-08-2020,0,22329,
1684,PEI,25-08-2020,2626,24955,
1685,PEI,26-08-2020,0,24955,
1686,PEI,27-08-2020,0,24955,
1687,PEI,28-08-2020,0,24955,
1688,PEI,29-08-2020,0,24955,
1689,PEI,30-08-2020,0,24955,
1690,Quebec,15-03-2020,2309,2309,
1691,Quebec,16-03-2020,820,3129,
1692,Quebec,17-03-2020,1723,4852,
1693,Quebec,18-03-2020,455,5307,
1694,Quebec,19-03-2020,1145,6452,
1695,Quebec,20-03-2020,1353,7805,
1696,Quebec,21-03-2020,1618,9423,
1697,Quebec,22-03-2020,582,10005,
1698,Quebec,23-03-2020,1834,11839,
1699,Quebec,24-03-2020,1376,13215,
1700,Quebec,25-03-2020,14758,27973,
1701,Quebec,26-03-2020,5510,33483,
1702,Quebec,27-03-2020,873,34356,
1703,Quebec,28-03-2020,11731,46087,
1704,Quebec,29-03-2020,6117,52204,
1705,Quebec,30-03-2020,7511,59715,
1706,Quebec,31-03-2020,7825,67540,
1707,Quebec,01-04-2020,2171,69711,
1708,Quebec,02-04-2020,4831,74542,
1709,Quebec,03-04-2020,9028,83570,
1710,Quebec,04-04-2020,6657,90227,
1711,Quebec,05-04-2020,5728,95955,
1712,Quebec,06-04-2020,4158,100113,
1713,Quebec,07-04-2020,4413,104526,
1714,Quebec,08-04-2020,4744,109270,
1715,Quebec,09-04-2020,4095,113365,
1716,Quebec,10-04-2020,4852,118217,
1717,Quebec,11-04-2020,4898,123115,
1718,Quebec,12-04-2020,3656,126771,
1719,Quebec,13-04-2020,4799,131570,
1720,Quebec,14-04-2020,5881,137451,
1721,Quebec,15-04-2020,5723,143174,
1722,Quebec,16-04-2020,5397,148571,
1723,Quebec,17-04-2020,5151,153722,
1724,Quebec,18-04-2020,5048,158770,
1725,Quebec,19-04-2020,4778,163548,
1726,Quebec,20-04-2020,4253,167801,
1727,Quebec,21-04-2020,3719,171520,
1728,Quebec,22-04-2020,4528,176048,
1729,Quebec,23-04-2020,4785,180833,
1730,Quebec,24-04-2020,4799,185632,
1731,Quebec,25-04-2020,5133,190765,
1732,Quebec,26-04-2020,4812,195577,
1733,Quebec,27-04-2020,4595,200172,
1734,Quebec,28-04-2020,4300,204472,
1735,Quebec,29-04-2020,4507,208979,
1736,Quebec,30-04-2020,5068,214047,
1737,Quebec,01-05-2020,5320,219367,
1738,Quebec,02-05-2020,5464,224831,
1739,Quebec,03-05-2020,6033,230864,
1740,Quebec,04-05-2020,4272,235136,
1741,Quebec,05-05-2020,4105,239241,
1742,Quebec,06-05-2020,11413,250654,
1743,Quebec,07-05-2020,9140,259794,
1744,Quebec,08-05-2020,6650,266444,
1745,Quebec,09-05-2020,10343,276787,
1746,Quebec,10-05-2020,1602,278389,
1747,Quebec,11-05-2020,5850,284239,
1748,Quebec,12-05-2020,6649,290888,
1749,Quebec,13-05-2020,5640,296528,
1750,Quebec,14-05-2020,6401,302929,
1751,Quebec,15-05-2020,7939,310868,
1752,Quebec,16-05-2020,8604,319472,
1753,Quebec,17-05-2020,8310,327782,
1754,Quebec,18-05-2020,7450,335232,
1755,Quebec,19-05-2020,5870,341102,
1756,Quebec,20-05-2020,5582,346684,
1757,Quebec,21-05-2020,7488,354172,
1758,Quebec,22-05-2020,7456,361628,
1759,Quebec,23-05-2020,9192,370820,
1760,Quebec,24-05-2020,9241,380061,
1761,Quebec,25-05-2020,9557,389618,
1762,Quebec,26-05-2020,6157,395775,
1763,Quebec,27-05-2020,6284,402059,
1764,Quebec,28-05-2020,7076,409135,
1765,Quebec,29-05-2020,8661,417796,
1766,Quebec,30-05-2020,11099,428895,
1767,Quebec,31-05-2020,7904,436799,
1768,Quebec,01-06-2020,7983,444782,
1769,Quebec,02-06-2020,5535,450317,
1770,Quebec,03-06-2020,6244,456561,
1771,Quebec,04-06-2020,6706,463267,
1772,Quebec,05-06-2020,7590,470857,
1773,Quebec,06-06-2020,6878,477735,
1774,Quebec,07-06-2020,7235,484970,
1775,Quebec,08-06-2020,4905,489875,
1776,Quebec,09-06-2020,3847,493722,
1777,Quebec,10-06-2020,4826,498548,
1778,Quebec,11-06-2020,5506,504054,
1779,Quebec,12-06-2020,5396,509450,
1780,Quebec,13-06-2020,5416,514866,
1781,Quebec,14-06-2020,6005,520871,
1782,Quebec,15-06-2020,4106,524977,
1783,Quebec,16-06-2020,3266,528243,
1784,Quebec,17-06-2020,4888,533131,
1785,Quebec,18-06-2020,5685,538816,
1786,Quebec,19-06-2020,6347,545163,
1787,Quebec,20-06-2020,6187,551350,
1788,Quebec,21-06-2020,84,551434,
1789,Quebec,22-06-2020,38,551472,
1790,Quebec,23-06-2020,12990,564462,
1791,Quebec,24-06-2020,4533,568995,
1792,Quebec,25-06-2020,4481,573476,
1793,Quebec,26-06-2020,5995,579471,
1794,Quebec,27-06-2020,5115,584586,
1795,Quebec,28-06-2020,79,584665,
1796,Quebec,29-06-2020,43,584708,
1797,Quebec,30-06-2020,15604,600312,
1798,Quebec,01-07-2020,4827,605139,
1799,Quebec,02-07-2020,5995,611134,
1800,Quebec,03-07-2020,5540,616674,
1801,Quebec,04-07-2020,5411,622085,
1802,Quebec,05-07-2020,75,622160,
1803,Quebec,06-07-2020,71,622231,
1804,Quebec,07-07-2020,22015,644246,
1805,Quebec,08-07-2020,4676,648922,
1806,Quebec,09-07-2020,7553,656475,
1807,Quebec,10-07-2020,7152,663627,
1808,Quebec,11-07-2020,8095,671722,
1809,Quebec,12-07-2020,111,671833,
1810,Quebec,13-07-2020,97,671930,
1811,Quebec,14-07-2020,20523,692453,
1812,Quebec,15-07-2020,7442,699895,
1813,Quebec,16-07-2020,9129,709024,
1814,Quebec,17-07-2020,9902,718926,
1815,Quebec,18-07-2020,11082,730008,
1816,Quebec,19-07-2020,8427,738435,
1817,Quebec,20-07-2020,9506,747941,
1818,Quebec,21-07-2020,10406,758347,
1819,Quebec,22-07-2020,9443,767790,
1820,Quebec,23-07-2020,-31531,736259,Change in reported testing definition.
1821,Quebec,24-07-2020,10851,747110,
1822,Quebec,25-07-2020,10703,757813,
1823,Quebec,26-07-2020,10533,768346,
1824,Quebec,27-07-2020,9447,777793,
1825,Quebec,28-07-2020,8934,786727,
1826,Quebec,29-07-2020,9822,796549,
1827,Quebec,30-07-2020,10815,807364,
1828,Quebec,31-07-2020,12353,819717,
1829,Quebec,01-08-2020,11352,831069,
1830,Quebec,02-08-2020,10716,841785,
1831,Quebec,03-08-2020,8845,850630,
1832,Quebec,04-08-2020,7386,858016,
1833,Quebec,05-08-2020,10095,868111,
1834,Quebec,06-08-2020,11239,879350,
1835,Quebec,07-08-2020,9652,889002,
1836,Quebec,08-08-2020,6494,895496,
1837,Quebec,09-08-2020,13036,908532,
1838,Quebec,10-08-2020,7769,916301,
1839,Quebec,11-08-2020,6031,922332,
1840,Quebec,12-08-2020,4206,926538,
1841,Quebec,13-08-2020,12606,939144,
1842,Quebec,14-08-2020,7882,947026,
1843,Quebec,15-08-2020,19651,966677,
1844,Quebec,16-08-2020,9179,975856,
1845,Quebec,17-08-2020,7958,983814,
1846,Quebec,18-08-2020,6578,990392,
1847,Quebec,19-08-2020,8032,998424,
1848,Quebec,20-08-2020,9828,1008252,
1849,Quebec,21-08-2020,17473,1025725,
1850,Quebec,22-08-2020,9102,1034827,
1851,Quebec,23-08-2020,10409,1045236,
1852,Quebec,24-08-2020,6021,1051257,
1853,Quebec,25-08-2020,5841,1057098,
1854,Quebec,26-08-2020,7575,1064673,
1855,Quebec,27-08-2020,5871,1070544,
1856,Quebec,28-08-2020,13800,1084344,
1857,Quebec,29-08-2020,9325,1093669,
1858,Quebec,30-08-2020,7521,1101190,
1859,Saskatchewan,15-03-2020,796,796,
1860,Saskatchewan,16-03-2020,311,1107,
1861,Saskatchewan,17-03-2020,0,1107,
1862,Saskatchewan,18-03-2020,871,1978,
1863,Saskatchewan,19-03-2020,583,2561,
1864,Saskatchewan,20-03-2020,532,3093,
1865,Saskatchewan,21-03-2020,824,3917,
1866,Saskatchewan,22-03-2020,619,4536,
1867,Saskatchewan,23-03-2020,733,5269,
1868,Saskatchewan,24-03-2020,488,5757,
1869,Saskatchewan,25-03-2020,513,6270,
1870,Saskatchewan,26-03-2020,459,6729,Change in reported testing definition.
1871,Saskatchewan,27-03-2020,631,7360,
1872,Saskatchewan,28-03-2020,649,8009,
1873,Saskatchewan,29-03-2020,813,8822,
1874,Saskatchewan,30-03-2020,550,9372,
1875,Saskatchewan,31-03-2020,452,9824,
1876,Saskatchewan,01-04-2020,378,10202,
1877,Saskatchewan,02-04-2020,832,11034,
1878,Saskatchewan,03-04-2020,686,11720,
1879,Saskatchewan,04-04-2020,524,12244,
1880,Saskatchewan,05-04-2020,811,13055,
1881,Saskatchewan,06-04-2020,625,13680,
1882,Saskatchewan,07-04-2020,523,14203,
1883,Saskatchewan,08-04-2020,856,15059,
1884,Saskatchewan,09-04-2020,1000,16059,
1885,Saskatchewan,10-04-2020,893,16952,
1886,Saskatchewan,11-04-2020,764,17716,
1887,Saskatchewan,12-04-2020,783,18499,
1888,Saskatchewan,13-04-2020,496,18995,
1889,Saskatchewan,14-04-2020,447,19442,
1890,Saskatchewan,15-04-2020,571,20013,
1891,Saskatchewan,16-04-2020,618,20631,
1892,Saskatchewan,17-04-2020,581,21212,
1893,Saskatchewan,18-04-2020,785,21997,
1894,Saskatchewan,19-04-2020,762,22759,
1895,Saskatchewan,20-04-2020,0,22759,
1896,Saskatchewan,21-04-2020,795,23554,
1897,Saskatchewan,22-04-2020,454,24008,
1898,Saskatchewan,23-04-2020,496,24504,
1899,Saskatchewan,24-04-2020,637,25141,
1900,Saskatchewan,25-04-2020,556,25697,
1901,Saskatchewan,26-04-2020,0,25697,
1902,Saskatchewan,27-04-2020,945,26642,
1903,Saskatchewan,28-04-2020,273,26915,
1904,Saskatchewan,29-04-2020,413,27328,
1905,Saskatchewan,30-04-2020,458,27786,
1906,Saskatchewan,01-05-2020,631,28417,
1907,Saskatchewan,02-05-2020,424,28841,
1908,Saskatchewan,03-05-2020,657,29498,
1909,Saskatchewan,04-05-2020,673,30171,
1910,Saskatchewan,05-05-2020,493,30664,
1911,Saskatchewan,06-05-2020,583,31247,
1912,Saskatchewan,07-05-2020,679,31926,
1913,Saskatchewan,08-05-2020,694,32620,
1914,Saskatchewan,09-05-2020,833,33453,
1915,Saskatchewan,10-05-2020,640,34093,
1916,Saskatchewan,11-05-2020,492,34585,
1917,Saskatchewan,12-05-2020,216,34801,
1918,Saskatchewan,13-05-2020,388,35189,
1919,Saskatchewan,14-05-2020,475,35664,
1920,Saskatchewan,15-05-2020,422,36086,
1921,Saskatchewan,16-05-2020,731,36817,
1922,Saskatchewan,17-05-2020,586,37403,
1923,Saskatchewan,18-05-2020,294,37697,
1924,Saskatchewan,19-05-2020,367,38064,
1925,Saskatchewan,20-05-2020,268,38332,
1926,Saskatchewan,21-05-2020,400,38732,
1927,Saskatchewan,22-05-2020,340,39072,
1928,Saskatchewan,23-05-2020,487,39559,
1929,Saskatchewan,24-05-2020,366,39925,
1930,Saskatchewan,25-05-2020,379,40304,
1931,Saskatchewan,26-05-2020,205,40509,
1932,Saskatchewan,27-05-2020,460,40969,
1933,Saskatchewan,28-05-2020,636,41605,
1934,Saskatchewan,29-05-2020,509,42114,
1935,Saskatchewan,30-05-2020,560,42674,
1936,Saskatchewan,31-05-2020,610,43284,
1937,Saskatchewan,01-06-2020,373,43657,
1938,Saskatchewan,02-06-2020,275,43932,
1939,Saskatchewan,03-06-2020,440,44372,
1940,Saskatchewan,04-06-2020,664,45036,
1941,Saskatchewan,05-06-2020,587,45623,
1942,Saskatchewan,06-06-2020,495,46118,
1943,Saskatchewan,07-06-2020,438,46556,
1944,Saskatchewan,08-06-2020,454,47010,
1945,Saskatchewan,09-06-2020,237,47247,
1946,Saskatchewan,10-06-2020,483,47730,
1947,Saskatchewan,11-06-2020,626,48356,
1948,Saskatchewan,12-06-2020,548,48904,
1949,Saskatchewan,13-06-2020,508,49412,
1950,Saskatchewan,14-06-2020,431,49843,
1951,Saskatchewan,15-06-2020,488,50331,
1952,Saskatchewan,16-06-2020,397,50728,
1953,Saskatchewan,17-06-2020,399,51127,
1954,Saskatchewan,18-06-2020,517,51644,
1955,Saskatchewan,19-06-2020,634,52278,
1956,Saskatchewan,20-06-2020,520,52798,
1957,Saskatchewan,21-06-2020,683,53481,
1958,Saskatchewan,22-06-2020,587,54068,
1959,Saskatchewan,23-06-2020,363,54431,
1960,Saskatchewan,24-06-2020,502,54933,
1961,Saskatchewan,25-06-2020,485,55418,
1962,Saskatchewan,26-06-2020,530,55948,
1963,Saskatchewan,27-06-2020,828,56776,
1964,Saskatchewan,28-06-2020,516,57292,
1965,Saskatchewan,29-06-2020,550,57842,
1966,Saskatchewan,30-06-2020,328,58170,
1967,Saskatchewan,01-07-2020,0,58170,
1968,Saskatchewan,02-07-2020,1061,59231,
1969,Saskatchewan,03-07-2020,449,59680,
1970,Saskatchewan,04-07-2020,0,59680,
1971,Saskatchewan,05-07-2020,0,59680,
1972,Saskatchewan,06-07-2020,1688,61368,
1973,Saskatchewan,07-07-2020,308,61676,
1974,Saskatchewan,08-07-2020,467,62143,
1975,Saskatchewan,09-07-2020,706,62849,
1976,Saskatchewan,10-07-2020,677,63526,
1977,Saskatchewan,11-07-2020,0,63526,
1978,Saskatchewan,12-07-2020,0,63526,
1979,Saskatchewan,13-07-2020,2147,65673,
1980,Saskatchewan,14-07-2020,484,66157,
1981,Saskatchewan,15-07-2020,745,66902,
1982,Saskatchewan,16-07-2020,965,67867,
1983,Saskatchewan,17-07-2020,939,68806,
1984,Saskatchewan,18-07-2020,0,68806,
1985,Saskatchewan,19-07-2020,2205,71011,
1986,Saskatchewan,20-07-2020,1116,72127,
1987,Saskatchewan,21-07-2020,600,72727,
1988,Saskatchewan,22-07-2020,1027,73754,
1989,Saskatchewan,23-07-2020,1235,74989,
1990,Saskatchewan,24-07-2020,1326,76315,
1991,Saskatchewan,25-07-2020,1531,77846,
1992,Saskatchewan,26-07-2020,1192,79038,
1993,Saskatchewan,27-07-2020,1382,80420,
1994,Saskatchewan,28-07-2020,730,81150,
1995,Saskatchewan,29-07-2020,1152,82302,
1996,Saskatchewan,30-07-2020,1436,83738,
1997,Saskatchewan,31-07-2020,1490,85228,
1998,Saskatchewan,01-08-2020,1586,86814,
1999,Saskatchewan,02-08-2020,1804,88618,
2000,Saskatchewan,03-08-2020,982,89600,
2001,Saskatchewan,04-08-2020,570,90170,
2002,Saskatchewan,05-08-2020,645,90815,
2003,Saskatchewan,06-08-2020,800,91615,
2004,Saskatchewan,07-08-2020,1773,93388,
2005,Saskatchewan,08-08-2020,1398,94786,
2006,Saskatchewan,09-08-2020,1545,96331,
2007,Saskatchewan,10-08-2020,1073,97404,
2008,Saskatchewan,11-08-2020,701,98105,
2009,Saskatchewan,12-08-2020,785,98890,
2010,Saskatchewan,13-08-2020,1496,100386,
2011,Saskatchewan,14-08-2020,1348,101734,
2012,Saskatchewan,15-08-2020,1632,103366,
2013,Saskatchewan,16-08-2020,1432,104798,
2014,Saskatchewan,17-08-2020,825,105623,
2015,Saskatchewan,18-08-2020,684,106307,
2016,Saskatchewan,19-08-2020,741,107048,
2017,Saskatchewan,20-08-2020,1164,108212,
2018,Saskatchewan,21-08-2020,976,109188,
2019,Saskatchewan,22-08-2020,1395,110583,
2020,Saskatchewan,23-08-2020,1015,111598,
2021,Saskatchewan,24-08-2020,803,112401,
2022,Saskatchewan,25-08-2020,312,112713,
2023,Saskatchewan,26-08-2020,946,113659,
2024,Saskatchewan,27-08-2020,1006,114665,
2025,Saskatchewan,28-08-2020,1249,115914,
2026,Saskatchewan,29-08-2020,1385,117299,
2027,Saskatchewan,30-08-2020,1002,118301,
2028,Yukon,15-03-2020,0,0,
2029,Yukon,16-03-2020,0,0,
2030,Yukon,17-03-2020,0,0,
2031,Yukon,18-03-2020,101,101,
2032,Yukon,19-03-2020,297,398,
2033,Yukon,20-03-2020,0,398,
2034,Yukon,21-03-2020,0,398,
2035,Yukon,22-03-2020,0,398,
2036,Yukon,23-03-2020,20,418,
2037,Yukon,24-03-2020,0,418,
2038,Yukon,25-03-2020,99,517,
2039,Yukon,26-03-2020,0,517,
2040,Yukon,27-03-2020,86,603,
2041,Yukon,28-03-2020,0,603,
2042,Yukon,29-03-2020,0,603,
2043,Yukon,30-03-2020,85,688,
2044,Yukon,31-03-2020,0,688,
2045,Yukon,01-04-2020,34,722,
2046,Yukon,02-04-2020,0,722,
2047,Yukon,03-04-2020,31,753,
2048,Yukon,04-04-2020,0,753,
2049,Yukon,05-04-2020,0,753,
2050,Yukon,06-04-2020,22,775,
2051,Yukon,07-04-2020,0,775,
2052,Yukon,08-04-2020,19,794,
2053,Yukon,09-04-2020,0,794,
2054,Yukon,10-04-2020,0,794,
2055,Yukon,11-04-2020,0,794,
2056,Yukon,12-04-2020,0,794,
2057,Yukon,13-04-2020,38,832,
2058,Yukon,14-04-2020,0,832,
2059,Yukon,15-04-2020,9,841,
2060,Yukon,16-04-2020,0,841,
2061,Yukon,17-04-2020,11,852,
2062,Yukon,18-04-2020,7,859,
2063,Yukon,19-04-2020,19,878,
2064,Yukon,20-04-2020,0,878,
2065,Yukon,21-04-2020,0,878,
2066,Yukon,22-04-2020,0,878,
2067,Yukon,23-04-2020,3,881,
2068,Yukon,24-04-2020,7,888,
2069,Yukon,25-04-2020,6,894,
2070,Yukon,26-04-2020,14,908,
2071,Yukon,27-04-2020,11,919,
2072,Yukon,28-04-2020,34,953,
2073,Yukon,29-04-2020,20,973,
2074,Yukon,30-04-2020,11,984,
2075,Yukon,01-05-2020,15,999,
2076,Yukon,02-05-2020,20,1019,
2077,Yukon,03-05-2020,4,1023,
2078,Yukon,04-05-2020,5,1028,
2079,Yukon,05-05-2020,13,1041,
2080,Yukon,06-05-2020,13,1054,
2081,Yukon,07-05-2020,11,1065,
2082,Yukon,08-05-2020,10,1075,
2083,Yukon,09-05-2020,7,1082,
2084,Yukon,10-05-2020,6,1088,
2085,Yukon,11-05-2020,6,1094,
2086,Yukon,12-05-2020,12,1106,
2087,Yukon,13-05-2020,6,1112,
2088,Yukon,14-05-2020,7,1119,
2089,Yukon,15-05-2020,5,1124,
2090,Yukon,16-05-2020,0,1124,
2091,Yukon,17-05-2020,0,1124,
2092,Yukon,18-05-2020,0,1124,
2093,Yukon,19-05-2020,10,1134,
2094,Yukon,20-05-2020,7,1141,
2095,Yukon,21-05-2020,1,1142,
2096,Yukon,22-05-2020,3,1145,
2097,Yukon,23-05-2020,0,1145,
2098,Yukon,24-05-2020,0,1145,
2099,Yukon,25-05-2020,0,1145,
2100,Yukon,26-05-2020,14,1159,
2101,Yukon,27-05-2020,4,1163,
2102,Yukon,28-05-2020,9,1172,
2103,Yukon,29-05-2020,4,1176,
2104,Yukon,30-05-2020,0,1176,
2105,Yukon,31-05-2020,0,1176,
2106,Yukon,01-06-2020,10,1186,
2107,Yukon,02-06-2020,6,1192,
2108,Yukon,03-06-2020,4,1196,
2109,Yukon,04-06-2020,5,1201,
2110,Yukon,05-06-2020,0,1201,
2111,Yukon,06-06-2020,0,1201,
2112,Yukon,07-06-2020,0,1201,
2113,Yukon,08-06-2020,13,1214,
2114,Yukon,09-06-2020,5,1219,
2115,Yukon,10-06-2020,9,1228,
2116,Yukon,11-06-2020,4,1232,
2117,Yukon,12-06-2020,3,1235,
2118,Yukon,13-06-2020,0,1235,
2119,Yukon,14-06-2020,0,1235,
2120,Yukon,15-06-2020,0,1235,
2121,Yukon,16-06-2020,8,1243,
2122,Yukon,17-06-2020,2,1245,
2123,Yukon,18-06-2020,5,1250,
2124,Yukon,19-06-2020,0,1250,
2125,Yukon,20-06-2020,0,1250,
2126,Yukon,21-06-2020,0,1250,
2127,Yukon,22-06-2020,0,1250,
2128,Yukon,23-06-2020,9,1259,
2129,Yukon,24-06-2020,6,1265,
2130,Yukon,25-06-2020,1,1266,
2131,Yukon,26-06-2020,6,1272,
2132,Yukon,27-06-2020,0,1272,
2133,Yukon,28-06-2020,0,1272,
2134,Yukon,29-06-2020,11,1283,
2135,Yukon,30-06-2020,6,1289,
2136,Yukon,01-07-2020,0,1289,
2137,Yukon,02-07-2020,0,1289,
2138,Yukon,03-07-2020,6,1295,
2139,Yukon,04-07-2020,0,1295,
2140,Yukon,05-07-2020,0,1295,
2141,Yukon,06-07-2020,11,1306,
2142,Yukon,07-07-2020,5,1311,
2143,Yukon,08-07-2020,6,1317,
2144,Yukon,09-07-2020,5,1322,
2145,Yukon,10-07-2020,5,1327,
2146,Yukon,11-07-2020,0,1327,
2147,Yukon,12-07-2020,0,1327,
2148,Yukon,13-07-2020,16,1343,
2149,Yukon,14-07-2020,13,1356,
2150,Yukon,15-07-2020,9,1365,
2151,Yukon,16-07-2020,11,1376,
2152,Yukon,17-07-2020,17,1393,
2153,Yukon,18-07-2020,0,1393,
2154,Yukon,19-07-2020,0,1393,
2155,Yukon,20-07-2020,24,1417,
2156,Yukon,21-07-2020,18,1435,
2157,Yukon,22-07-2020,15,1450,
2158,Yukon,23-07-2020,19,1469,
2159,Yukon,24-07-2020,19,1488,
2160,Yukon,25-07-2020,0,1488,
2161,Yukon,26-07-2020,0,1488,
2162,Yukon,27-07-2020,35,1523,
2163,Yukon,28-07-2020,24,1547,
2164,Yukon,29-07-2020,0,1547,
2165,Yukon,30-07-2020,41,1588,
2166,Yukon,31-07-2020,24,1612,
2167,Yukon,01-08-2020,0,1612,
2168,Yukon,02-08-2020,0,1612,
2169,Yukon,03-08-2020,0,1612,
2170,Yukon,04-08-2020,128,1740,
2171,Yukon,05-08-2020,29,1769,
2172,Yukon,06-08-2020,23,1792,
2173,Yukon,07-08-2020,44,1836,
2174,Yukon,08-08-2020,0,1836,
2175,Yukon,09-08-2020,0,1836,
2176,Yukon,10-08-2020,125,1961,
2177,Yukon,11-08-2020,56,2017,
2178,Yukon,12-08-2020,45,2062,
2179,Yukon,13-08-2020,50,2112,
2180,Yukon,14-08-2020,44,2156,
2181,Yukon,15-08-2020,0,2156,
2182,Yukon,16-08-2020,0,2156,
2183,Yukon,17-08-2020,0,2156,
2184,Yukon,18-08-2020,91,2247,
2185,Yukon,19-08-2020,23,2270,
2186,Yukon,20-08-2020,28,2298,
2187,Yukon,21-08-2020,37,2335,
2188,Yukon,22-08-2020,0,2335,
2189,Yukon,23-08-2020,0,2335,
2190,Yukon,24-08-2020,43,2378,
2191,Yukon,25-08-2020,45,2423,
2192,Yukon,26-08-2020,36,2459,
2193,Yukon,27-08-2020,36,2495,
2194,Yukon,28-08-2020,23,2518,
2195,Yukon,29-08-2020,0,2518,
2196,Yukon,30-08-2020,0,2518,
